51 51 51 51 51 51 51 51 51 51 51 51 51 51 51 51 51 51 51 51 51 51 51 51 51 51 51 51 51 51 51 51 
51 52 52 52 52 52 52 52 52 52 52 52 52 52 53 52 52 52 52 52 52 52 52 52 52 52 52 52 52 52 52 51 
51 52 54 55 56 57 52 52 52 52 52 52 52 52 53 52 52 52 52 52 52 52 52 52 52 52 52 52 52 52 52 51 
51 52 58 59 60 61 52 52 52 52 52 52 52 52 53 52 52 52 62 63 52 52 52 52 52 52 62 63 52 52 52 51 
51 52 64 65 66 67 52 52 52 52 52 52 52 52 53 52 52 52 68 69 52 52 52 52 52 52 68 69 52 52 52 51 
51 52 70 71 72 73 52 52 52 52 52 52 52 52 53 52 52 52 52 52 52 52 52 52 52 52 52 52 52 52 52 51 
51 52 74 75 76 77 52 52 52 52 52 52 52 52 53 52 52 52 52 52 52 52 52 52 52 52 52 52 52 52 52 51 
51 52 78 79 79 80 52 52 52 52 52 52 52 52 53 52 52 52 52 52 52 52 52 52 52 52 52 52 52 52 52 51 
51 52 52 52 52 52 52 52 52 52 52 52 52 52 53 52 52 52 52 52 52 52 52 52 52 52 52 52 52 52 52 51 
51 52 52 52 52 52 52 52 52 52 52 52 52 52 53 52 52 52 52 52 52 52 52 52 52 52 52 52 52 52 52 51 
51 53 53 53 53 53 53 53 52 52 52 52 53 53 53 52 52 52 52 52 52 52 52 52 52 52 52 52 52 52 52 51 
51 52 52 52 52 52 52 52 52 52 52 52 52 52 52 52 52 52 52 52 52 52 52 52 52 52 52 52 52 52 52 51 
51 52 52 52 52 52 52 52 52 52 52 52 52 52 52 52 52 52 52 52 52 52 52 52 52 52 52 52 52 52 52 51 
51 52 52 52 52 52 52 52 52 52 52 52 52 52 52 52 52 52 52 52 52 52 81 82 82 83 83 52 84 52 52 51 
51 52 52 52 52 52 52 52 52 52 52 52 52 52 52 52 52 52 52 52 52 52 85 86 86 87 88 52 52 52 52 51 
51 53 53 53 53 53 53 53 53 53 53 53 53 53 53 52 52 52 52 52 52 52 52 52 52 52 52 52 52 52 52 51 
51 52 52 52 52 52 52 52 52 52 52 52 52 52 53 52 52 52 52 52 52 52 52 52 52 52 52 52 52 52 52 51 
51 52 89 90 52 52 52 52 52 52 52 52 52 52 53 52 52 52 52 52 52 52 52 52 52 52 52 52 52 52 52 51 
51 52 91 92 52 52 52 52 52 52 52 52 52 52 53 52 52 52 52 52 52 52 52 52 52 52 52 52 52 52 52 51 
51 52 52 52 52 52 52 52 52 52 52 52 52 52 53 52 52 52 52 52 52 52 52 52 52 52 52 52 52 52 52 51 
51 52 52 52 52 52 52 52 52 52 52 52 52 52 53 52 52 52 52 52 52 52 52 52 52 52 52 52 52 52 52 51 
51 52 52 52 52 52 52 52 52 52 52 52 52 52 52 52 52 52 52 52 52 52 52 52 52 52 52 52 52 52 52 51 
51 52 52 52 52 52 52 52 52 52 52 52 52 52 52 52 52 52 52 52 52 52 52 52 52 52 52 52 52 52 52 51 
51 52 52 93 94 95 96 52 52 52 97 52 52 52 52 52 52 52 52 52 52 52 52 52 52 52 52 52 52 52 52 51
51 52 52 98 99 100 101 52 52 52 102 52 52 52 52 52 52 52 52 52 52 52 52 52 52 52 52 52 52 52 52 51 
51 52 52 52 52 52 52 52 52 52 52 52 52 52 52 52 52 52 52 52 52 52 52 52 52 52 52 52 52 52 52 51 
51 52 52 52 52 52 52 52 52 52 52 52 52 52 53 52 52 52 52 52 52 52 52 52 52 52 52 52 52 52 52 51 
51 52 52 52 52 52 52 52 52 52 52 52 52 52 53 52 52 52 52 52 52 52 52 52 52 52 52 52 52 52 52 51 
51 52 52 52 103 52 52 52 52 52 52 52 52 52 53 52 52 52 52 52 52 52 52 52 52 52 52 52 52 52 52 51 
51 52 52 52 52 52 52 52 52 52 52 52 52 52 53 52 52 52 52 52 52 52 52 52 52 52 52 52 52 52 52 51 
51 52 52 52 52 52 52 52 52 52 52 52 52 52 53 52 52 52 52 52 52 52 52 52 52 52 52 52 52 52 52 51 
51 51 51 51 51 51 51 51 51 51 51 51 51 51 51 51 51 51 51 51 51 51 51 51 52 52 52 52 52 51 51 51




