169 169 169 169 169 169 169 169 169 169 169 169 169 169 169 169 169 169 169 169 169 169 169 169 169 169 169 169 169 169 169 169                   
169 47 47 47 47 47 47 47 47 47 47 47 47 47 47 47 47 47 47 47 47 47 47 47 47 47 47 47 47 47 47 169                   
169 47 47 47 47 47 47 47 47 47 47 47 47 47 87 88 87 88 47 47 47 47 47 47 47 47 47 47 47 47 47 169                   
169 47 47 47 47 47 47 47 47 47 47 47 47 47 89 90 89 90 47 47 47 47 47 47 47 47 47 47 47 47 47 169                   
169 47 47 47 47 85 47 23 24 25 47 85 47 47 47 47 47 47 47 47 47 47 47 47 47 47 47 47 47 47 47 169                   
169 47 47 47 47 86 47 26 27 28 47 86 47 47 47 47 47 47 47 47 47 47 47 47 47 47 47 47 47 47 47 169                   
169 47 47 47 47 47 47 29 30 31 47 47 47 47 47 47 47 47 47 47 47 47 47 47 47 47 47 47 47 47 47 169                   
169 47 47 47 47 47 47 47 47 47 47 47 47 47 47 47 47 47 47 47 47 85 93 96 85 47 47 47 47 159 47 169
169 47 47 47 47 47 47 47 47 47 47 47 47 47 47 47 47 47 47 47 47 86 97 100 86 47 47 47 47 159 47 169
169 47 47 47 47 47 47 47 47 47 47 47 47 47 47 47 47 47 47 47 47 47 47 47 47 47 47 47 47 47 47 169                   
169 47 47 47 47 47 47 47 47 47 47 47 47 47 47 47 47 47 47 47 47 47 47 47 47 47 47 47 47 47 47 169                   
169 47 47 47 47 48 36 37 37 38 39 48 47 47 47 47 47 47 47 47 47 47 47 47 47 47 47 47 47 47 47 169                   
169 47 47 47 47 47 40 41 42 42 43 47 47 47 47 47 47 47 47 47 47 47 47 47 47 47 47 47 47 47 47 169                   
169 47 47 47 47 47 47 47 47 47 47 47 47 47 47 47 47 47 47 47 47 47 47 47 47 47 47 47 47 47 47 169                   
169 47 47 47 47 47 47 47 47 47 47 47 47 47 47 47 47 47 47 47 47 47 47 47 47 47 47 47 47 47 47 169                   
169 47 47 47 47 47 47 47 47 47 47 47 47 47 47 47 47 47 47 47 47 47 47 47 47 47 47 47 47 47 47 169                   
169 47 47 47 47 47 47 47 167 47 47 47 47 47 47 47 47 47 47 47 47 47 47 47 47 47 47 47 47 47 47 169
169 47 47 47 47 47 47 47 47 47 47 47 47 47 47 47 47 47 47 47 47 47 47 47 47 47 47 47 47 47 47 169                   
169 47 47 47 47 47 47 47 47 47 47 47 47 47 47 47 47 47 47 47 47 47 47 47 47 47 47 47 47 47 47 169                   
169 47 47 47 47 47 47 47 47 47 47 47 47 47 47 47 47 47 47 47 47 47 47 47 47 47 47 47 47 47 47 169                   
169 169 169 169 169 169 169 169 169 169 169 169 169 169 169 169 169 47 47 47 47 47 47 47 47 47 47 47 47 47 47 169                   
169 47 47 47 47 47 47 47 47 47 47 47 47 47 47 47 169 47 47 47 47 47 132 133 134 47 47 47 47 47 47 169                   
169 47 47 47 47 47 47 47 47 47 47 47 47 47 47 47 169 47 47 47 47 47 135 136 137 47 47 47 47 47 47 169                   
169 47 47 47 47 47 47 47 47 47 47 47 47 47 47 47 169 47 47 47 47 47 138 139 140 47 47 47 47 47 47 169                   
169 47 87 88 47 150 151 47 47 47 47 150 151 47 47 47 169 47 47 47 47 47 47 47 47 47 47 47 47 47 47 169
169 47 89 90 47 152 153 47 2 2 47 152 153 47 47 47 47 47 47 47 47 47 47 47 47 47 47 47 47 47 47 169
169 47 47 47 47 154 155 47 47 47 47 154 155 47 47 47 47 47 47 47 47 47 47 47 47 47 47 47 47 47 47 169
169 47 47 47 47 156 157 47 47 47 47 156 157 47 47 47 47 47 47 47 47 47 47 47 47 47 47 47 47 47 47 169
169 47 47 47 47 47 47 47 47 47 47 47 47 47 47 47 169 47 47 47 47 47 47 47 47 47 47 47 47 47 47 169                   
169 47 47 47 47 47 47 47 47 47 47 47 47 47 47 47 169 47 47 47 47 47 47 47 47 47 47 47 47 47 47 169                   
169 47 47 47 47 47 47 47 47 47 47 47 47 47 47 47 169 47 47 47 47 47 47 47 47 47 47 47 47 47 47 169
169 169 169 169 169 169 169 169 169 169 169 169 169 169 169 169 169 169 169 169 169 169 169 47 47 47 47 169 169 169 169 169
