135 135 135 135 135 135 135 135 135 135 135 135 135 135 135 135 135 135 135 135 135 135 135 135 135 135 135 135 135 135 135 135 
135 29 29 29 29 29 29 29 29 29 29 29 29 29 29 29 29 29 29 29 29 29 29 29 29 29 29 29 29 29 29 135
135 29 29 29 29 29 29 29 29 29 29 29 29 29 29 29 29 29 29 29 29 29 29 29 29 29 29 29 29 29 29 135
135 29 29 29 108 109 109 109 109 109 109 109 109 110 29 29 29 18 19 19 19 19 19 21 29 29 26 29 29 29 29 135
135 29 29 29 111 112 112 112 112 112 112 112 112 113 29 29 29 22 23 23 23 23 23 25 29 29 27 29 29 29 29 135
135 29 29 29 114 115 115 115 115 115 115 115 115 116 29 29 29 29 29 29 29 29 29 29 29 29 29 29 29 29 29 135
135 29 29 29 29 29 29 29 29 29 29 29 29 29 29 29 29 29 29 29 29 29 29 29 29 29 29 29 29 29 29 135
135 29 29 29 29 29 29 29 29 29 29 29 29 29 29 29 29 29 29 29 29 29 29 29 29 29 29 29 29 29 29 135
135 29 29 29 29 29 29 29 29 29 29 29 29 29 29 29 29 29 29 29 29 29 29 29 29 29 29 29 29 29 29 135
135 29 29 29 29 29 29 29 29 29 29 29 29 29 29 29 29 29 29 29 29 29 29 29 29 29 29 29 29 29 29 135
135 29 29 29 29 29 29 29 29 29 29 29 29 29 29 29 29 29 29 29 29 29 29 29 29 29 29 29 29 29 29 135
135 29 29 29 29 29 29 29 29 29 29 30 13 30 13 30 13 30 13 30 13 29 29 29 29 29 29 29 29 29 29 135
135 29 29 14 15 29 29 29 29 29 29 13 28 28 28 28 28 28 28 28 30 29 29 29 67 73 76 67 29 29 126 135
135 29 29 16 17 29 29 29 29 29 29 30 28 28 28 28 28 28 28 28 13 29 29 29 68 77 80 68 29 29 126 135
135 29 29 29 29 29 29 29 29 29 29 13 28 28 28 28 28 28 28 28 30 29 29 29 29 29 29 29 29 29 126 135
135 29 29 29 29 29 29 29 29 29 29 30 28 28 28 28 28 28 28 28 13 29 29 29 29 29 29 29 29 29 29 135
135 29 29 29 29 29 29 29 29 29 29 13 30 13 30 13 30 13 30 13 30 29 29 29 29 29 29 29 29 29 29 135
135 29 29 134 29 29 29 29 29 29 29 29 29 29 29 29 29 29 29 29 29 29 29 29 29 29 29 29 29 29 29 135
135 29 29 29 29 29 29 29 29 29 29 29 29 29 29 29 29 29 29 29 29 29 29 29 29 29 29 29 29 29 29 135
135 29 29 29 29 29 29 29 29 29 29 29 29 29 29 29 29 29 29 29 29 29 29 29 29 29 29 29 29 29 29 135
135 69 70 69 70 69 70 69 70 69 70 69 70 29 29 29 29 29 29 29 29 29 29 29 29 29 29 29 29 29 29 135
135 71 72 71 72 71 72 71 72 71 72 71 72 29 29 30 29 29 29 29 29 29 29 29 29 29 29 29 29 29 29 135
135 29 29 29 29 29 29 29 29 29 29 29 29 29 29 30 29 29 29 29 29 29 29 29 29 29 29 29 29 29 29 135
135 29 29 29 29 29 29 29 29 29 29 29 29 29 29 30 29 29 29 29 29 29 29 29 29 29 29 29 29 29 29 135
135 29 29 29 29 95 101 102 29 29 29 29 29 29 29 30 29 29 29 29 29 29 29 29 29 29 29 29 29 29 29 135
135 29 29 29 103 104 105 106 29 29 29 29 29 29 29 30 29 29 29 29 29 29 29 29 29 29 29 29 29 29 29 135
135 29 29 29 107 85 86 87 29 29 29 29 29 29 29 30 29 29 29 29 29 29 29 29 29 29 29 29 29 29 29 135
135 29 29 29 88 89 90 91 29 29 29 29 29 29 29 30 29 29 29 29 29 29 29 29 29 29 29 29 29 29 29 135
135 29 29 29 92 93 94 124 29 29 29 29 29 29 29 30 29 29 29 29 29 29 29 29 29 29 29 29 29 29 29 135
135 29 29 29 97 98 99 100 29 29 29 29 29 29 29 30 29 29 29 29 29 29 29 29 29 29 29 29 29 29 29 135
135 29 29 29 29 29 29 29 29 29 29 29 29 29 29 30 29 29 29 29 29 29 29 29 29 29 29 29 29 29 29 135
135 135 135 135 135 135 135 135 135 135 135 135 135 135 135 135 135 135 135 135 135 135 135 29 29 29 29 29 135 135 135 135