135 135 135 135 135 135 135 135 135 135 135 135 135 135 135 135 135 135 135 135 135 135 135 135 135 135 135 135 135 135 135 135 
135 4 4 4 4 4 4 4 4 4 4 4 4 4 4 4 4 4 4 4 4 4 4 4 4 4 4 4 4 4 4 135 
135 4 4 4 4 4 4 4 4 4 4 4 4 4 4 4 4 4 4 4 4 4 4 4 4 4 4 4 4 4 4 135 
135 4 4 4 108 109 109 109 109 109 109 109 109 110 4 4 4 18 19 19 19 19 19 21 4 4 26 4 4 4 4 135 
135 4 4 4 111 112 112 112 112 112 112 112 112 113 4 4 4 22 23 23 23 23 23 25 4 4 27 4 4 4 4 135 
135 4 4 4 114 115 115 115 115 115 115 115 115 116 4 4 4 4 4 4 4 4 4 4 4 4 4 4 4 4 4 135 
135 4 4 4 4 4 4 4 4 4 4 4 4 4 4 4 4 4 4 4 4 4 4 4 4 4 4 4 4 4 4 135 
135 4 4 4 4 4 4 4 4 4 4 4 4 4 4 4 4 4 4 4 4 4 4 4 4 4 4 4 4 4 4 135 
135 4 4 4 4 4 4 4 4 4 4 4 4 4 4 4 4 4 4 4 4 4 4 4 4 4 4 4 4 4 4 135 
135 42 4 4 4 4 4 4 4 4 4 4 4 4 4 4 4 4 4 4 4 4 4 4 4 4 4 4 4 4 4 135 
135 29 29 29 29 4 4 4 4 4 4 4 4 4 4 4 4 4 4 4 4 4 4 4 4 4 4 4 4 4 4 135 
135 29 29 29 29 29 29 4 4 4 4 30 13 30 13 30 13 30 13 30 13 4 4 4 4 4 4 4 4 4 4 135 
135 4 4 14 15 4 4 4 4 4 4 13 28 28 28 28 28 28 28 28 30 4 4 4 67 73 76 67 4 4 126 135 
135 4 4 16 17 4 4 4 4 29 29 30 28 28 28 28 28 28 28 28 13 4 4 4 68 77 80 68 4 4 126 135 
135 4 4 4 4 4 4 4 4 4 29 13 28 28 28 28 28 28 28 28 30 4 4 4 4 4 4 4 4 4 126 135 
135 4 4 29 4 29 29 29 4 4 4 30 28 28 28 28 28 28 28 28 13 4 4 4 4 4 29 4 4 4 4 135 
135 4 29 4 4 29 29 29 29 29 4 13 30 13 30 13 30 13 30 13 30 29 4 4 4 4 4 4 4 4 4 135 
135 4 29 134 29 29 29 29 4 4 4 4 4 4 4 4 4 4 4 4 4 4 4 4 4 4 4 4 4 4 4 135 
135 4 29 4 4 4 4 4 4 4 4 4 4 4 4 4 4 4 4 4 29 4 29 4 4 4 4 4 4 4 4 135 
135 4 29 4 4 4 4 4 4 4 4 4 4 4 4 4 4 4 4 4 4 4 4 4 4 4 4 4 4 4 4 135 
135 69 70 69 70 69 70 69 70 69 70 69 70 4 4 4 4 4 4 4 4 4 4 4 4 4 29 4 4 4 4 135 
135 71 72 71 72 71 72 71 72 71 72 71 72 4 4 30 4 4 4 4 4 29 29 4 29 29 29 4 4 4 4 135 
135 4 4 4 4 4 4 4 4 29 4 4 4 4 4 30 4 4 4 4 29 29 29 29 29 29 29 4 4 4 4 135 
135 4 4 4 4 4 4 4 4 4 4 4 4 4 4 30 4 4 4 4 4 4 4 4 4 4 4 4 4 4 4 135 
135 29 29 4 4 95 101 102 4 29 29 29 29 29 29 30 29 29 29 29 29 29 29 29 29 29 29 29 29 29 29 135 
135 29 29 29 103 104 105 106 29 29 29 29 29 29 29 30 29 29 29 29 29 29 29 29 29 29 29 29 29 29 29 135 
135 29 29 29 107 85 86 87 29 29 29 29 29 29 29 30 29 29 29 29 29 29 29 29 29 29 29 29 29 29 29 135 
135 29 29 29 88 89 90 91 29 29 29 29 29 29 29 30 29 29 29 29 29 29 29 29 29 29 29 29 29 29 29 135 
135 29 29 29 92 93 94 124 29 29 29 29 29 29 29 30 29 29 29 29 29 29 29 29 29 29 29 29 29 29 29 135 
135 29 29 29 97 98 99 100 29 29 29 29 29 29 29 30 29 29 29 29 29 29 29 29 29 29 29 29 29 29 29 135 
135 29 29 29 29 29 29 29 29 29 29 29 29 29 29 30 29 29 29 29 29 29 29 29 29 29 29 29 29 29 29 135 
135 135 135 135 135 135 135 135 135 135 135 135 135 135 135 135 135 135 135 135 135 135 135 29 29 29 29 29 135 135 135 135 