135 135 135 135 135 135 135 135 135 135 135 135 135 135 135 135 135 135 135 135 135 135 135 135 135 135 135 135 135 135 135 135 
135 29 29 29 29 29 29 29 29 29 29 29 29 29 29 29 29 29 29 29 29 29 29 29 29 29 29 29 29 29 29 135 
135 29 29 29 29 29 29 29 29 117 118 29 29 29 117 118 29 29 29 117 118 29 29 29 29 29 29 29 29 29 29 135 
135 29 29 14 15 29 29 29 2 119 120 2 29 2 119 120 2 29 2 119 120 2 29 29 29 29 29 14 15 29 29 135 
135 29 29 16 17 29 29 29 29 121 122 29 29 29 121 122 29 29 29 121 122 29 29 29 29 29 29 16 17 29 29 135 
135 29 29 29 29 29 29 29 29 123 124 29 29 29 123 124 29 29 29 123 124 29 29 29 29 29 29 29 29 29 29 135 
135 29 29 29 29 29 29 29 29 29 29 29 29 29 29 29 29 29 29 29 29 29 29 29 29 29 29 29 29 29 29 135 
135 29 29 29 29 29 29 29 29 29 29 29 29 29 29 29 29 29 29 29 29 29 29 29 29 29 29 29 29 29 29 135 
135 30 30 30 30 30 30 30 30 29 29 29 29 29 29 29 29 29 29 29 29 30 30 30 30 30 30 30 30 30 30 135 
135  29 29 29 29 29 29 29 29 29 29 29 29 29 29 29 29 29 29 29 29 29 29 29 29 29 29 29 29 29 135
135 29 29 29 29 29 29 29 29 29 29 29 29 29 29 29 29 29 29 29 29 29 29 29 29 29 29 29 29 29 29 135 
135 29 29 29 29 29 29 29 29 29 29 29 29 29 29 29 29 29 29 29 29 29 29 29 29 29 29 29 29 29 29 135 
135 29 29 29 29 29 29 29 29 30 29 18 19 19 19 19 19 19 19 21 29 30 29 29 29 29 29 29 29 29 29 135 
135 29 29 29 29 29 29 29 29 30 29 22 23 23 23 23 23 23 23 25 29 30 29 29 29 29 29 29 29 29 29 135 
135 29 29 29 29 29 29 29 29 29 29 108 109 109 109 109 109 109 109 110 29 29 29 29 29 29 29 29 29 29 29 135 
135 29 29 29 29 29 29 29 29 29 29 114 115 115 115 115 115 115 115 116 29 29 29 29 29 29 29 29 29 29 29 135 
135 29 29 29 29 29 29 29 29 29 29 29 29 29 29 29 29 29 29 29 29 29 29 29 29 29 29 29 29 29 29 135 
135 29 29 29 29 29 29 29 29 29 29 29 29 29 29 29 29 29 29 29 29 29 29 29 29 29 29 29 29 29 29 135 
135 29 29 29 29 29 29 29 29 29 29 29 29 29 29 134 29 29 29 29 29 29 29 29 29 29 29 29 29 29 29 135 
135 29 29 29 29 29 29 29 29 29 29 29 29 29 29 29 29 29 29 29 29 29 29 29 29 29 29 29 29 29 126 135 
135 29 29 29 29 29 29 29 29 29 29 29 29 29 29 29 29 29 29 29 29 29 67 73 74 74 74 76 67 29 126 135 
135 125 125 125 125 125 125 125 125 125 29 29 29 29 29 29 29 29 29 29 29 29 68 77 78 78 78 80 68 29 126 135 
135 82 82 82 82 82 82 82 82 125 29 29 29 29 29 29 29 29 29 29 29 29 29 29 29 29 29 29 29 29 126 135 
135 82 82 82 82 82 82 82 82 125 29 29 29 29 29 29 29 29 29 29 29 29 29 29 29 29 29 29 29 29 29 135 
135 82 82 82 82 82 82 82 82 125 29 29 29 29 29 29 29 29 29 29 29 29 29 29 29 29 29 29 29 29 29 135 
135 82 82 82 82 82 82 82 82 125 29 29 29 29 29 29 29 29 29 29 29 29 29 29 29 29 29 29 29 29 29 135 
135 82 82 82 82 82 82 82 82 125 29 29 29 29 29 29 29 29 29 29 29 29 29 29 29 29 29 29 29 29 29 135 
135 82 82 82 82 82 82 82 82 125 29 29 29 29 29 29 29 29 29 29 29 29 29 29 29 29 29 29 29 29 29 135 
135 82 82 82 82 82 82 82 82 125 29 29 29 29 29 29 29 29 29 29 29 29 29 29 29 29 29 29 29 29 29 135 
135 82 82 82 82 82 82 82 82 29 29 29 29 29 29 29 29 29 29 29 29 29 29 29 29 29 29 29 29 29 29 135 
135 82 82 82 82 82 82 82 82 29 29 29 29 29 29 29 29 29 29 29 29 29 29 29 29 29 29 29 29 29 29 135 
135 135 135 135 135 135 135 135 135 135 135 135 135 135 135 135 135 135 135 135 135 135 135 29 29 29 29 29 135 135 135 135 