135 135 135 135 135 135 135 135 135 135 135 135 135 135 135 135 135 135 135 135 135 135 135 135 135 135 135 135 135 135 135 135 
135 4 4 4 4 4 4 4 4 4 4 4 4 4 4 4 4 4 4 4 4 4 4 4 4 4 4 4 4 4 4 135 
135 4 4 4 4 4 4 4 4 117 118 4 4 4 117 118 4 4 4 117 118 4 4 4 4 4 4 4 4 4 4 135 
135 4 4 14 15 4 4 4 2 119 120 2 4 2 119 120 2 4 2 119 120 2 4 4 4 4 4 14 15 4 4 135 
135 4 4 16 17 4 4 4 4 121 122 4 4 4 121 122 4 4 4 121 122 4 4 4 4 4 4 16 17 4 4 135 
135 4 4 4 4 4 4 4 4 123 124 4 4 4 123 124 4 4 4 123 124 4 4 4 4 4 4 4 4 4 4 135 
135 4 4 4 4 4 4 4 4 4 4 4 4 4 4 4 4 4 4 4 4 4 4 4 4 4 4 4 4 4 4 135 
135 4 4 4 4 4 4 4 4 4 4 4 4 4 4 4 4 4 4 4 4 4 4 4 4 4 4 4 4 4 4 135 
135 30 30 30 30 30 30 30 30 4 4 4 4 4 4 4 4 4 4 4 4 30 30 30 30 30 30 30 30 30 30 135 
135 42 4 4 4 4 4 4 4 4 4 4 4 4 4 4 4 4 4 4 4 4 4 4 4 4 4 4 4 4 4 135 
135 29 29 29 29 4 4 4 4 4 4 4 4 4 4 4 4 4 4 4 4 4 4 4 4 4 4 4 4 4 4 135 
135 29 29 29 4 29 29 4 4 4 4 4 4 4 4 4 4 4 4 4 4 4 4 4 4 4 4 4 4 4 4 135 
135 4 4 4 4 4 4 4 4 30 4 18 19 19 19 19 19 19 19 21 4 30 4 4 4 4 4 4 4 4 4 135 
135 4 4 4 4 4 4 4 4 30 4 22 23 23 23 23 23 23 23 25 4 30 4 4 4 4 4 4 4 4 4 135 
135 4 4 4 4 4 4 4 4 4 4 108 109 109 109 109 109 109 109 110 4 4 4 4 4 4 4 4 4 4 4 135 
135 4 4 29 4 29 29 29 4 4 4 114 115 115 115 115 115 115 115 116 4 4 4 4 4 4 29 4 4 4 4 135 
135 4 29 4 4 4 29 4 4 4 4 4 4 4 4 4 4 4 4 4 4 4 4 4 4 4 4 4 4 4 4 135 
135 4 29 4 4 4 29 29 4 4 4 4 4 4 4 4 4 4 4 4 4 4 4 4 4 4 4 4 4 4 4 135 
135 4 4 4 4 4 4 4 4 4 4 4 4 4 4 134 4 4 4 4 29 4 29 4 4 4 4 4 4 4 4 135 
135 4 4 4 4 4 4 4 4 4 4 4 4 4 4 4 4 4 4 4 4 4 4 4 4 4 4 4 4 4 126 135 
135 4 4 4 4 4 4 4 4 4 4 4 4 4 4 4 4 4 4 4 4 4 67 73 74 74 74 76 67 4 126 135 
135 125 125 125 125 125 125 125 125 125 4 4 4 4 4 4 4 4 4 4 4 29 68 77 78 78 78 80 68 4 126 135 
135 82 82 82 82 82 82 82 82 125 4 4 4 4 4 4 4 4 4 4 29 29 29 29 29 29 29 4 4 4 126 135 
135 82 82 82 82 82 82 82 82 125 4 4 4 4 4 4 4 4 4 4 4 4 4 4 4 4 4 4 4 4 4 135 
135 82 82 82 82 82 82 82 82 125 29 29 29 29 4 4 29 29 29 29 29 29 29 29 29 29 29 29 29 29 29 135 
135 82 82 82 82 82 82 82 82 125 29 29 29 29 4 4 4 29 29 29 29 29 29 29 29 29 29 29 29 29 29 135 
135 82 82 82 82 82 82 82 82 125 29 29 29 29 4 4 4 29 29 29 29 29 29 29 29 29 29 29 29 29 29 135 
135 82 82 82 82 82 82 82 82 125 29 29 29 29 4 4 4 29 29 29 29 29 29 29 29 29 29 29 29 29 29 135 
135 82 82 82 82 82 82 82 82 125 29 29 29 29 4 4 29 29 29 29 29 29 29 29 29 29 29 29 29 29 29 135 
135 82 82 82 82 82 82 82 82 29 29 29 29 29 29 4 29 29 29 29 29 29 29 29 29 29 29 29 29 29 29 135 
135 82 82 82 82 82 82 82 82 29 29 29 29 29 29 4 29 29 29 29 29 29 29 29 29 29 29 29 29 29 29 135 
135 135 135 135 135 135 135 135 135 135 135 135 135 135 135 135 135 135 135 135 135 135 135 29 29 29 29 29 135 135 135 135 