10 15 15 15 13 8 8 4 4 4 4 4 4 8 10 15 13 8 4 4 4 8 10 15 13 8 8 8 4 4 4 4 4
9 14 14 14 14 15 15 13 8 4 4 4 8 10 14 14 14 13 8 8 8 10 14 14 14 15 13 8 8 8 4 4 4
9 14 14 14 14 14 14 14 14 13 8 10 15 14 14 14 14 14 15 15 15 14 14 18 14 14 14 15 15 13 8 4 4
9 14 14 14 14 14 14 14 14 14 15 14 14 14 14 14 14 14 14 14 14 18 14 18 14 18 18 14 14 14 13 8 4
9 14 14 14 14 14 14 14 14 14 14 14 14 14 14 14 14 14 14 14 14 14 14 14 14 14 14 14 14 14 11 8 4
9 14 14 14 14 14 14 14 14 14 14 14 14 14 14 14 14 14 14 14 14 14 14 14 14 14 14 14 14 11 8 8 4
9 14 14 14 14 14 14 14 14 14 14 14 14 14 14 14 14 14 14 14 14 14 14 14 14 14 14 14 12 8 8 4 4
9 14 14 14 14 14 14 14 14 14 14 14 14 14 14 14 14 14 14 14 14 14 14 14 14 14 14 14 12 8 4 4 4
9 14 14 14 14 14 14 14 14 14 14 14 14 14 14 14 14 14 14 14 14 14 14 14 14 14 14 14 12 8 8 4 4
9 14 18 14 18 14 14 14 14 14 14 14 14 14 14 14 14 14 14 14 18 14 14 14 14 14 14 18 14 13 8 4 4
6 14 14 18 14 14 14 14 14 14 14 14 14 14 14 14 14 14 14 14 14 14 14 14 14 14 14 14 14 14 13 8 4
8 6 14 18 14 14 14 14 14 14 14 14 14 14 14 14 14 14 14 14 14 14 14 14 14 14 14 14 14 14 11 8 8
4 8 9 14 14 14 14 14 14 14 14 14 14 14 14 14 14 14 14 14 14 14 14 14 14 14 14 14 14 12 8 8 8
4 8 9 14 14 14 14 14 14 14 14 14 14 14 14 14 14 14 14 14 14 14 14 14 14 14 14 14 14 12 8 8 8
4 4 6 14 14 14 14 14 14 14 14 14 14 14 14 14 14 14 14 14 14 14 14 14 14 14 14 14 14 14 13 8 8
4 4 8 9 14 14 14 14 14 14 14 14 14 14 14 14 14 14 14 14 14 14 14 14 14 14 14 14 14 14 12 8 8
4 4 10 14 14 14 14 14 14 14 14 14 14 14 14 14 14 14 14 14 14 14 14 14 14 14 14 14 14 14 11 8 8
4 8 9 14 14 14 14 14 14 14 14 14 14 14 14 14 14 14 14 14 14 14 14 14 14 14 14 14 14 12 8 8 8
8 10 14 14 18 14 14 14 14 14 14 14 14 14 14 14 14 14 14 14 14 14 14 14 14 14 14 14 14 14 13 8 8
10 14 18 18 14 14 14 14 14 14 14 14 14 14 14 14 14 14 14 14 14 14 14 14 14 14 14 14 14 14 14 13 8
6 14 18 14 14 14 14 14 14 14 14 14 14 14 14 14 14 14 14 14 14 14 14 14 14 14 14 14 14 14 14 12 8
8 6 14 14 18 14 14 14 14 14 14 14 14 14 14 14 14 14 14 14 14 14 14 14 14 14 14 14 14 14 14 14 13
4 8 6 14 14 14 14 14 14 14 14 14 14 14 14 14 14 14 14 14 14 14 14 14 14 14 14 14 14 14 14 14 12
4 4 8 9 14 14 14 14 14 14 14 14 14 14 14 14 14 14 14 14 14 14 14 14 14 14 14 14 14 14 14 14 12
4 4 10 14 14 14 14 14 14 14 14 14 14 14 14 14 14 14 14 14 14 14 14 14 14 14 14 14 14 14 14 14 12
4 8 9 14 14 14 14 14 14 14 14 14 14 14 14 14 14 14 14 14 14 14 14 14 14 14 14 14 14 14 14 18 12
8 10 14 18 14 14 14 14 14 14 14 14 14 14 14 14 14 14 14 14 14 14 14 14 14 14 14 14 14 14 18 18 11
10 14 18 14 14 14 14 14 14 14 14 14 14 14 14 14 14 14 14 14 14 14 14 14 14 14 14 14 14 14 14 12 8
9 14 14 14 14 14 14 14 14 14 14 14 14 14 14 14 14 14 14 14 14 14 14 14 14 14 14 14 14 14 14 12 8
9 5 5 5 5 14 14 18 14 14 18 14 14 14 14 14 14 14 14 14 18 14 14 77 14 14 14 14 14 14 7 11 8
9 5 5 5 5 14 14 14 14 18 14 14 18 14 18 14 18 14 14 18 14 14 14 78 18 18 18 14 7 11 8 8 8
9 5 5 5 5 14 14 18 14 14 14 14 14 14 14 18 14 14 14 14 14 14 14 14 18 14 14 11 8 8 8 8 8 8 6 7 7 7 7 7 7 7 7 7 7 7 7 7 7 7 7 7 7 7 7 7 7 7 7 7 11 8 8 8 8 8 8
