1 3 5 0 2 4 1 5 0 3 2 4 1 5 0 3 2 4 1 5 0 3 2 4 1 5 0 3 2 4 1 5 0 3 2 4 1 5 0 3 2 4 1 5 0 3 2 4 1 5
0 2 4 1 5 0 3 2 4 1 5 0 3 2 4 1 5 0 3 2 4 1 5 0 3 2 4 1 5 0 3 2 4 1 5 0 3 2 4 1 5 0 3 2 4 1 5 0 3 2
5 0 3 2 4 1 5 0 3 2 4 1 5 0 3 2 4 1 5 0 3 2 4 1 5 0 3 2 4 1 5 0 3 2 4 1 5 0 3 2 4 1 5 0 3 2 4 1 5 0
2 4 1 5 0 3 2 4 1 5 0 3 2 4 1 5 0 3 2 4 1 5 0 3 2 4 1 5 0 3 2 4 1 5 0 3 2 4 1 5 0 3 2 4 1 5 0 3 2 4
3 5 0 3 2 4 1 5 0 3 2 4 1 5 0 3 2 4 1 5 0 3 2 4 1 5 0 3 2 4 1 5 0 3 2 4 1 5 0 3 2 4 1 5 0 3 2 4 1 5
1 0 2 4 1 5 0 3 2 4 1 5 0 3 2 4 1 5 0 3 2 4 1 5 0 3 2 4 1 5 0 3 2 4 1 5 0 3 2 4 1 5 0 3 2 4 1 5 0 3
4 1 5 0 3 2 4 1 5 0 3 2 4 1 5 0 3 2 4 1 5 0 3 2 4 1 5 0 3 2 4 1 5 0 3 2 4 1 5 0 3 2 4 1 5 0 3 2 4 1
0 3 2 4 1 5 0 3 2 4 1 5 0 3 2 4 1 5 0 3 2 4 1 5 0 3 2 4 1 5 0 3 2 4 1 5 0 3 2 4 1 5 0 3 2 4 1 5 0 3
2 4 1 5 0 3 2 4 1 5 0 3 2 4 1 5 0 3 2 4 1 5 0 3 2 4 1 5 0 3 2 4 1 5 0 3 2 4 1 5 0 3 2 4 1 5 0 3 2 4
5 0 3 2 4 1 5 0 3 2 4 1 5 0 3 2 4 1 5 0 3 2 4 1 5 0 3 2 4 1 5 0 3 2 4 1 5 0 3 2 4 1 5 0 3 2 4 1 5 0
3 2 4 1 5 0 3 2 4 1 5 0 3 2 4 1 5 0 3 2 4 1 5 0 3 2 4 1 5 0 3 2 4 1 5 0 3 2 4 1 5 0 3 2 4 1 5 0 3 2 4
1 5 0 3 2 4 1 5 0 3 2 4 1 5 0 3 2 4 1 5 0 3 2 4 1 5 0 3 2 4 1 5 0 3 2 4 1 5 0 3 2 4 1 5 0 3 2 4 1 5
0 3 2 4 1 5 0 3 2 4 1 5 0 3 2 4 1 5 0 3 2 4 1 5 0 3 2 4 1 5 0 3 2 4 1 5 0 3 2 4 1 5 0 3 2 4 1 5 0 3
2 4 1 5 0 3 2 4 1 5 0 3 2 4 1 5 0 3 2 4 1 5 0 3 2 4 1 5 0 3 2 4 1 5 0 3 2 4 1 5 0 3 2 4 1 5 0 3 2 4
4 1 5 0 3 2 4 1 5 0 3 2 4 1 5 0 3 2 4 1 5 0 3 2 4 1 5 0 3 2 4 1 5 0 3 2 4 1 5 0 3 2 4 1 5 0 3 2 4 1
5 0 3 2 4 1 5 0 3 2 4 1 5 0 3 2 4 1 5 0 3 2 4 1 5 0 3 2 4 1 5 0 3 2 4 1 5 0 3 2 4 1 5 0 3 2 4 1 5 0
0 2 4 1 5 0 3 2 4 1 5 0 3 2 4 1 5 0 3 2 4 1 5 0 3 2 4 1 5 0 3 2 4 1 5 0 3 2 4 1 5 0 3 2 4 1 5 0 3 2
1 5 0 3 2 4 1 5 0 3 2 4 1 5 0 3 2 4 1 5 0 3 2 4 1 5 0 3 2 4 1 5 0 3 2 4 1 5 0 3 2 4 1 5 0 3 2 4 1 5
3 2 4 1 5 0 3 2 4 1 5 0 3 2 4 1 5 0 3 2 4 1 5 0 3 2 4 1 5 0 3 2 4 1 5 0 3 2 4 1 5 0 3 2 4 1 5 0 3 2 4
4 1 5 0 3 2 4 1 5 0 3 2 4 1 5 0 3 2 4 1 5 0 3 2 4 1 5 0 3 2 4 1 5 0 3 2 4 1 5 0 3 2 4 1 5 0 3 2 4 1
2 4 1 5 0 3 2 4 1 5 0 3 2 4 1 5 0 3 2 4 1 5 0 3 2 4 1 5 0 3 2 4 1 5 0 3 2 4 1 5 0 3 2 4 1 5 0 3 2 4
5 0 3 2 4 1 5 0 3 2 4 1 5 0 3 2 4 1 5 0 3 2 4 1 5 0 3 2 4 1 5 0 3 2 4 1 5 0 3 2 4 1 5 0 3 2 4 1 5 0
0 3 2 4 1 5 0 3 2 4 1 5 0 3 2 4 1 5 0 3 2 4 1 5 0 3 2 4 1 5 0 3 2 4 1 5 0 3 2 4 1 5 0 3 2 4 1 5 0 3
1 5 0 3 2 4 1 5 0 3 2 4 1 5 0 3 2 4 1 5 0 3 2 4 1 5 0 3 2 4 1 5 0 3 2 4 1 5 0 3 2 4 1 5 0 3 2 4 1 5
3 2 4 1 5 0 3 2 4 1 5 0 3 2 4 1 5 0 3 2 4 1 5 0 3 2 4 1 5 0 3 2 4 1 5 0 3 2 4 1 5 0 3 2 4 1 5 0 3 2 4
4 1 5 0 3 2 4 1 5 0 3 2 4 1 5 0 3 2 4 1 5 0 3 2 4 1 5 0 3 2 4 1 5 0 3 2 4 1 5 0 3 2 4 1 5 0 3 2 4 1
2 4 1 5 0 3 2 4 1 5 0 3 2 4 1 5 0 3 2 4 1 5 0 3 2 4 1 5 0 3 2 4 1 5 0 3 2 4 1 5 0 3 2 4 1 5 0 3 2 4
5 0 3 2 4 1 5 0 3 2 4 1 5 0 3 2 4 1 5 0 3 2 4 1 5 0 3 2 4 1 5 0 3 2 4 1 5 0 3 2 4 1 5 0 3 2 4 1 5 0
0 3 2 4 1 5 0 3 2 4 1 5 0 3 2 4 1 5 0 3 2 4 1 5 0 3 2 4 1 5 0 3 2 4 1 5 0 3 2 4 1 5 0 3 2 4 1 5 0 3
1 5 0 3 2 4 1 5 0 3 2 4 1 5 0 3 2 4 1 5 0 3 2 4 1 5 0 3 2 4 1 5 0 3 2 4 1 5 0 3 2 4 1 5 0 3 2 4 1 5
3 2 4 1 5 0 3 2 4 1 5 0 3 2 4 1 5 0 3 2 4 1 5 0 3 2 4 1 5 0 3 2 4 1 5 0 3 2 4 1 5 0 3 2 4 1 5 0 3 2 4
4 1 5 0 3 2 4 1 5 0 3 2 4 1 5 0 3 2 4 1 5 0 3 2 4 1 5 0 3 2 4 1 5 0 3 2 4 1 5 0 3 2 4 1 5 0 3 2 4 1
2 4 1 5 0 3 2 4 1 5 0 3 2 4 1 5 0 3 2 4 1 5 0 3 2 4 1 5 0 3 2 4 1 5 0 3 2 4 1 5 0 3 2 4 1 5 0 3 2 4
5 0 3 2 4 1 5 0 3 2 4 1 5 0 3 2 4 1 5 0 3 2 4 1 5 0 3 2 4 1 5 0 3 2 4 1 5 0 3 2 4 1 5 0 3 2 4 1 5 0
0 3 2 4 1 5 0 3 2 4 1 5 0 3 2 4 1 5 0 3 2 4 1 5 0 3 2 4 1 5 0 3 2 4 1 5 0 3 2 4 1 5 0 3 2 4 1 5 0 3
1 5 0 3 2 4 1 5 0 3 2 4 1 5 0 3 2 4 1 5 0 3 2 4 1 5 0 3 2 4 1 5 0 3 2 4 1 5 0 3 2 4 1 5 0 3 2 4 1 5
3 2 4 1 5 0 3 2 4 1 5 0 3 2 4 1 5 0 3 2 4 1 5 0 3 2 4 1 5 0 3 2 4 1 5 0 3 2 4 1 5 0 3 2 4 1 5 0 3 2 4
4 1 5 0 3 2 4 1 5 0 3 2 4 1 5 0 3 2 4 1 5 0 3 2 4 1 5 0 3 2 4 1 5 0 3 2 4 1 5 0 3 2 4 1 5 0 3 2 4 1
2 4 1 5 0 3 2 4 1 5 0 3 2 4 1 5 0 3 2 4 1 5 0 3 2 4 1 5 0 3 2 4 1 5 0 3 2 4 1 5 0 3 2 4 1 5 0 3 2 4
5 0 3 2 4 1 5 0 3 2 4 1 5 0 3 2 4 1 5 0 3 2 4 1 5 0 3 2 4 1 5 0 3 2 4 1 5 0 3 2 4 1 5 0 3 2 4 1 5 0
0 3 2 4 1 5 0 3 2 4 1 5 0 3 2 4 1 5 0 3 2 4 1 5 0 3 2 4 1 5 0 3 2 4 1 5 0 3 2 4 1 5 0 3 2 4 1 5 0 3
1 5 0 3 2 4 1 5 0 3 2 4 1 5 0 3 2 4 1 5 0 3 2 4 1 5 0 3 2 4 1 5 0 3 2 4 1 5 0 3 2 4 1 5 0 3 2 4 1 5
3 2 4 1 5 0 3 2 4 1 5 0 3 2 4 1 5 0 3 2 4 1 5 0 3 2 4 1 5 0 3 2 4 1 5 0 3 2 4 1 5 0 3 2 4 1 5 0 3 2 4
4 1 5 0 3 2 4 1 5 0 3 2 4 1 5 0 3 2 4 1 5 0 3 2 4 1 5 0 3 2 4 1 5 0 3 2 4 1 5 0 3 2 4 1 5 0 3 2 4 1
2 4 1 5 0 3 2 4 1 5 0 3 2 4 1 5 0 3 2 4 1 5 0 3 2 4 1 5 0 3 2 4 1 5 0 3 2 4 1 5 0 3 2 4 1 5 0 3 2 4
5 0 3 2 4 1 5 0 3 2 4 1 5 0 3 2 4 1 5 0 3 2 4 1 5 0 3 2 4 1 5 0 3 2 4 1 5 0 3 2 4 1 5 0 3 2 4 1 5 0
0 3 2 4 1 5 0 3 2 4 1 5 0 3 2 4 1 5 0 3 2 4 1 5 0 3 2 4 1 5 0 3 2 4 1 5 0 3 2 4 1 5 0 3 2 4 1 5 0 3
1 5 0 3 2 4 1 5 0 3 2 4 1 5 0 3 2 4 1 5 0 3 2 4 1 5 0 3 2 4 1 5 0 3 2 4 1 5 0 3 2 4 1 5 0 3 2 4 1 5
3 2 4 1 5 0 3 2 4 1 5 0 3 2 4 1 5 0 3 2 4 1 5 0 3 2 4 1 5 0 3 2 4 1 5 0 3 2 4 1 5 0 3 2 4 1 5 0 3 2 4
4 1 5 0 3 2 4 1 5 0 3 2 4 1 5 0 3 2 4 1 5 0 3 2 4 1 5 0 3 2 4 1 5 0 3 2 4 1 5 0 3 2 4 1 5 0 3 2 4 1
