0 11 28 28 28 28 28 30 31 1 2 3 4 5 6 7 8 9 10 12 13 14 15 16 17 18 19 20 20 20 20 553 484 0 0 0 0 0 0 0 0 0 0 0 0 0 0 0 0 0 
22 26 29 29 29 29 381 346 347 306 339 355 356 357 358 333 180 151 151 151 151 134 103 368 369 370 371 372 373 375 375 376 484 0 0 0 0 0 0 0 0 0 0 0 0 0 0 0 0 0
317 317 317 317 317 317 733 734 735 705 706 707 708 709 710 711 712 713 714 716 717 718 719 720 721 722 723 724 725 727 772 728 484 0 0 0 0 0 0 0 0 0 0 0 0 0 0 0 0 0
700 700 700 700 700 700 861 862 863 833 834 835 836 837 838 839 819 841 842 844 845 846 847 848 849 850 851 852 853 855 845 856 484 0 0 0 0 0 0 0 0 0 0 0 0 0 0 0 0 0 
860 860 860 860 860 860 893 894 895 898 898 898 868 869 870 871 872 873 874 876 877 878 879 880 881 882 883 884 885 887 888 888 484 0 0 0 0 0 0 0 0 0 0 0 0 0 0 0 0 0 
896 907 922 924 923 923 828 819 631 244 802 532 900 901 902 903 904 905 906 908 909 910 911 912 913 914 915 916 917 919 920 921 484 0 0 0 0 0 0 0 0 0 0 0 0 0 0 0 0 0 
928 926 950 988 988 988 957 958 959 929 969 970 972 933 934 935 936 937 938 940 941 942 943 944 945 946 947 948 949 951 952 952 484 0 0 0 0 0 0 0 0 0 0 0 0 0 0 0 0 0 
960 816 982 986 987 987 989 990 991 937 976 976 976 965 966 967 968 976 970 972 973 974 975 976 976 553 976 976 976 553 976 984 484 0 0 0 0 0 0 0 0 0 0 0 0 0 0 0 0 0 
224 235 225 250 28 28 843 449 457 993 976 995 996 997 998 999 977 977 977 977 977 977 977 977 595 596 993 994 994 994 994 994 484 0 0 0 0 0 0 0 0 0 0 0 0 0 0 0 0 0 
964 960 904 58 59 60 62 62 63 83 34 35 36 36 38 39 40 41 42 44 553 46 46 48 49 50 51 52 582 583 584 56 484 0 0 0 0 0 0 0 0 0 0 0 0 0 0 0 0 0 
79 80 816 90 91 92 93 94 95 98 99 77 77 69 70 71 72 73 74 76 77 77 79 80 81 81 83 87 134 135 136 56 484 0 0 0 0 0 0 0 0 0 0 0 0 0 0 0 0 0 
96 97 97 122 123 125 125 126 127 147 98 99 77 101 102 103 104 105 106 108 109 110 111 112 113 114 115 116 366 647 680 120 484 0 0 0 0 0 0 0 0 0 0 0 0 0 0 0 0 0 
160 139 426 154 155 156 157 158 159 161 144 163 164 133 134 135 136 137 138 140 141 142 145 145 145 145 145 98 844 743 848 277 484 0 0 0 0 0 0 0 0 0 0 0 0 0 0 0 0 0
160 171 182 143 187 188 189 190 191 193 194 195 553 739 742 743 744 782 751 752 755 755 755 755 755 755 755 402 717 775 848 856 484 0 0 0 0 0 0 0 0 0 0 0 0 0 0 0 0 0
192 173 173 250 768 222 222 222 223 210 275 276 293 293 774 775 776 783 753 753 753 753 753 816 753 753 753 841 806 879 943 976 484 0 0 0 0 0 0 0 0 0 0 0 0 0 0 0 0 0
964 395 346 347 348 891 891 891 893 817 841 842 293 803 804 807 808 815 818 818 818 818 818 818 818 818 818 841 946 947 487 487 484 0 0 0 0 0 0 0 0 0 0 0 0 0 0 0 0 0
505 424 428 410 283 252 252 252 989 257 257 258 259 260 261 262 263 264 269 816 269 269 269 269 210 210 210 276 293 293 293 293 484 0 0 0 0 0 0 0 0 0 0 0 0 0 0 0 0 0
469 267 428 429 430 412 413 413 574 570 639 696 696 609 655 658 692 692 816 692 692 692 692 692 692 692 705 714 714 714 714 714 484 0 0 0 0 0 0 0 0 0 0 0 0 0 0 0 0 0
320 331 333 333 333 316 351 351 351 351 321 209 306 641 626 628 629 631 335 631 631 335 335 335 335 335 410 387 389 389 389 389 484 0 0 0 0 0 0 0 0 0 0 0 0 0 0 0 0 0
624 488 406 406 406 412 413 413 413 413 385 329 209 329 330 335 335 410 410 335 335 335 816 410 410 410 410 410 387 389 389 389 484 0 0 0 0 0 0 0 0 0 0 0 0 0 0 0 0 0
340 357 358 306 443 444 446 447 447 447 417 296 209 410 410 410 410 410 410 410 410 410 410 410 410 816 410 410 410 599 389 389 484 0 0 0 0 0 0 0 0 0 0 0 0 0 0 0 0 0
706 657 632 506 507 508 509 510 510 413 449 209 430 961 928 430 410 410 410 410 410 431 432 410 410 410 410 410 428 429 599 714 484 0 0 0 0 0 0 0 0 0 0 0 0 0 0 0 0 0
459 410 218 219 222 413 413 413 413 413 513 430 991 969 960 430 430 430 430 430 339 388 388 235 430 430 430 430 840 430 712 713 484 0 0 0 0 0 0 0 0 0 0 0 0 0 0 0 0 0
202 206 250 251 222 222 222 222 222 575 430 430 841 969 992 430 430 430 430 212 388 388 388 388 235 430 430 430 430 430 430 430 484 0 0 0 0 0 0 0 0 0 0 0 0 0 0 0 0 0
270 271 538 508 508 508 508 508 508 481 430 430 841 553 969 992 430 430 430 212 388 388 388 388 388 327 430 430 430 430 430 430 484 0 0 0 0 0 0 0 0 0 0 0 0 0 0 0 0 0
257 538 507 221 221 221 221 221 221 449 430 840 712 751 706 752 430 430 430 430 244 388 388 553 388 388 327 430 840 430 430 430 484 0 0 0 0 0 0 0 0 0 0 0 0 0 0 0 0 0
221 221 285 221 221 221 221 252 252 126 430 430 833 706 783 430 430 430 430 430 430 244 388 388 388 388 388 327 430 430 816 430 484 0 0 0 0 0 0 0 0 0 0 0 0 0 0 0 0 0
252 252 252 285 285 252 252 252 252 449 430 833 867 752 430 430 816 430 430 430 430 386 387 389 389 388 388 388 235 430 430 430 484 0 0 0 0 0 0 0 0 0 0 0 0 0 0 0 0 0
252 252 285 252 285 252 252 252 252 417 323 831 459 430 840 430 430 430 430 430 430 430 430 387 293 389 389 389 389 835 431 432 484 0 0 0 0 0 0 0 0 0 0 0 0 0 0 0 0 0
252 252 285 252 252 285 252 252 252 671 360 391 327 430 430 430 430 430 430 816 430 430 816 430 354 389 389 389 389 293 293 293 484 0 0 0 0 0 0 0 0 0 0 0 0 0 0 0 0 0
252 252 285 285 285 285 285 252 252 733 360 391 427 327 430 430 816 430 430 430 430 430 354 389 389 390 389 389 389 389 293 293 484 0 0 0 0 0 0 0 0 0 0 0 0 0 0 0 0 0
252 252 285 285 285 285 252 252 702 703 354 391 391 391 327 430 430 430 430 430 430 354 389 390 389 553 389 389 389 389 293 293 484 0 0 0 0 0 0 0 0 0 0 0 0 0 0 0 0 0
484 484 484 484 484 484 484 484 484 484 484 484 484 484 484 484 484 484 484 484 484 484 484 484 484 484 484 484 484 484 484 484 484 484 0 0 0 0 0 0 0 0 0 0 0 0 0 0 0 0
0 0 0 0 0 0 0 0 0 0 0 0 0 0 0 0 0 0 0 0 0 0 0 0 0 0 0 0 0 0 0 0 0 0 0 0 0 0 0 0 0 0 0 0 0 0 0 0 0 0
0 0 0 0 0 0 0 0 0 0 0 0 0 0 0 0 0 0 0 0 0 0 0 0 0 0 0 0 0 0 0 0 0 0 0 0 0 0 0 0 0 0 0 0 0 0 0 0 0 0
0 0 0 0 0 0 0 0 0 0 0 0 0 0 0 0 0 0 0 0 0 0 0 0 0 0 0 0 0 0 0 0 0 0 0 0 0 0 0 0 0 0 0 0 0 0 0 0 0 0
0 0 0 0 0 0 0 0 0 0 0 0 0 0 0 0 0 0 0 0 0 0 0 0 0 0 0 0 0 0 0 0 0 0 0 0 0 0 0 0 0 0 0 0 0 0 0 0 0 0
0 0 0 0 0 0 0 0 0 0 0 0 0 0 0 0 0 0 0 0 0 0 0 0 0 0 0 0 0 0 0 0 0 0 0 0 0 0 0 0 0 0 0 0 0 0 0 0 0 0
0 0 0 0 0 0 0 0 0 0 0 0 0 0 0 0 0 0 0 0 0 0 0 0 0 0 0 0 0 0 0 0 0 0 0 0 0 0 0 0 0 0 0 0 0 0 0 0 0 0
0 0 0 0 0 0 0 0 0 0 0 0 0 0 0 0 0 0 0 0 0 0 0 0 0 0 0 0 0 0 0 0 0 0 0 0 0 0 0 0 0 0 0 0 0 0 0 0 0 0
0 0 0 0 0 0 0 0 0 0 0 0 0 0 0 0 0 0 0 0 0 0 0 0 0 0 0 0 0 0 0 0 0 0 0 0 0 0 0 0 0 0 0 0 0 0 0 0 0 0
0 0 0 0 0 0 0 0 0 0 0 0 0 0 0 0 0 0 0 0 0 0 0 0 0 0 0 0 0 0 0 0 0 0 0 0 0 0 0 0 0 0 0 0 0 0 0 0 0 0
0 0 0 0 0 0 0 0 0 0 0 0 0 0 0 0 0 0 0 0 0 0 0 0 0 0 0 0 0 0 0 0 0 0 0 0 0 0 0 0 0 0 0 0 0 0 0 0 0 0
0 0 0 0 0 0 0 0 0 0 0 0 0 0 0 0 0 0 0 0 0 0 0 0 0 0 0 0 0 0 0 0 0 0 0 0 0 0 0 0 0 0 0 0 0 0 0 0 0 0
0 0 0 0 0 0 0 0 0 0 0 0 0 0 0 0 0 0 0 0 0 0 0 0 0 0 0 0 0 0 0 0 0 0 0 0 0 0 0 0 0 0 0 0 0 0 0 0 0 0
0 0 0 0 0 0 0 0 0 0 0 0 0 0 0 0 0 0 0 0 0 0 0 0 0 0 0 0 0 0 0 0 0 0 0 0 0 0 0 0 0 0 0 0 0 0 0 0 0 0
0 0 0 0 0 0 0 0 0 0 0 0 0 0 0 0 0 0 0 0 0 0 0 0 0 0 0 0 0 0 0 0 0 0 0 0 0 0 0 0 0 0 0 0 0 0 0 0 0 0
0 0 0 0 0 0 0 0 0 0 0 0 0 0 0 0 0 0 0 0 0 0 0 0 0 0 0 0 0 0 0 0 0 0 0 0 0 0 0 0 0 0 0 0 0 0 0 0 0 0
0 0 0 0 0 0 0 0 0 0 0 0 0 0 0 0 0 0 0 0 0 0 0 0 0 0 0 0 0 0 0 0 0 0 0 0 0 0 0 0 0 0 0 0 0 0 0 0 0 0
0 0 0 0 0 0 0 0 0 0 0 0 0 0 0 0 0 0 0 0 0 0 0 0 0 0 0 0 0 0 0 0 0 0 0 0 0 0 0 0 0 0 0 0 0 0 0 0 0 0
