125 125 125 125 125 125 125 125 125 125 125 125 125 125 125 125 125 125 125 125 125 125 125 125 125 125 125 125 125 125 125 125 
125 29 29 29 29 29 29 29 29 29 29 29 29 29 29 29 29 29 29 29 29 29 29 29 29 29 29 29 29 29 29 125 
125 29 29 29 29 29 29 29 29 29 29 29 29 29 29 29 29 29 29 29 29 29 29 29 29 29 29 29 29 29 29 125 
125 29 29 29 29 29 29 29 29 29 29 29 29 29 26 29 29 29 29 117 118 29 29 29 29 117 118 29 29 29 29 125
125 29 29 29 18 19 20 21 29 29 29 29 29 29 27 29 29 29 3 119 120 3 4 4 3 119 120 3 29 29 29 125
125 29 29 29 22 23 24 25 29 29 29 29 29 29 29 29 29 29 29 121 122 29 29 29 29 121 122 29 29 29 29 125
125 29 29 29 29 29 29 29 29 29 29 29 29 29 29 29 29 29 29 123 124 29 29 29 29 123 124 29 29 29 29 125
125 29 29 29 29 29 29 29 29 29 29 29 29 29 29 29 29 29 29 29 29 29 29 29 29 29 29 29 29 29 29 125 
125 29 29 29 29 29 29 29 29 29 29 29 29 29 29 29 29 29 29 29 29 108 109 110 29 29 29 29 29 29 29 125 
125 29 29 29 29 134 29 29 29 29 29 29 29 29 29 29 29 29 29 29 29 114 115 116 29 29 29 29 29 29 29 125
125 29 29 29 29 29 29 29 29 29 29 29 29 29 29 29 29 29 29 29 29 29 29 29 29 29 29 29 29 29 29 125     
125 69 70 69 70 69 70 69 70 69 70 29 29 29 29 29 29 29 29 29 29 29 29 29 29 29 29 29 29 29 29 125 
125 71 72 71 72 71 72 71 72 71 72 30 30 30 30 29 29 29 29 29 29 29 29 29 29 29 29 29 29 29 29 125 
125 29 29 29 29 29 29 29 29 29 29 29 29 29 29 29 29 29 29 29 29 29 29 29 29 29 29 29 29 29 29 125 
125 29 29 29 29 29 29 29 29 29 29 29 29 29 29 29 29 29 29 29 29 29 29 29 125 125 125 125 125 125 125 125 
125 29 29 29 29 29 29 29 29 29 29 29 29 29 29 29 29 29 29 29 29 29 29 29 125 81 81 81 81 81 81 125 
125 29 29 29 29 29 67 67 29 29 29 29 29 29 29 29 29 29 29 29 29 29 29 29 125 81 81 81 81 81 81 125 
125 29 29 29 29 29 68 68 29 29 29 29 29 29 29 29 29 29 29 29 29 29 29 29 125 81 81 81 81 81 81 125 
125 29 29 67 29 73 74 75 76 29 67 29 29 29 29 29 29 29 29 29 29 29 29 29 125 81 81 81 81 81 81 125 
125 29 29 68 29 77 78 79 80 29 68 29 29 29 29 29 29 29 29 29 29 29 29 29 125 81 81 81 81 81 81 125 
125 29 29 29 29 29 29 29 29 29 29 29 29 29 29 29 29 29 29 29 29 29 29 29 125 81 81 81 81 81 81 125 
125 29 29 29 29 29 29 29 29 29 29 29 29 29 29 29 29 29 29 29 29 29 29 29 125 81 81 81 81 81 81 125 
125 29 29 29 29 29 29 29 29 29 29 29 29 29 29 29 29 29 29 29 29 29 29 29 125 125 125 125 125 29 29 125 
125 29 29 29 29 29 29 29 29 29 29 29 29 29 29 29 29 29 29 29 29 29 29 29 29 29 29 29 29 29 29 125 
125 29 29 29 29 29 29 29 29 29 29 29 29 29 29 29 29 29 29 29 29 29 29 29 29 29 29 29 29 29 29 125 
125 29 29 29 29 29 29 29 29 29 29 29 29 29 26 29 29 29 29 29 29 29 29 29 29 29 29 29 29 29 29 125 
125 29 29 29 29 29 29 29 29 29 29 29 29 29 27 29 29 29 29 29 29 29 29 29 29 29 29 29 29 29 29 125 
125 29 29 29 29 29 29 29 29 29 29 29 29 29 29 29 29 29 29 29 29 29 29 29 29 29 29 29 29 29 29 125 
125 29 29 29 29 29 29 29 29 29 29 29 29 29 29 29 29 29 29 29 29 29 29 29 29 29 29 29 29 29 29 125 
125 29 29 29 29 126 126 126 126 29 29 29 29 29 29 29 29 29 29 29 29 29 29 29 29 29 29 29 29 29 29 125
125 29 29 29 29 29 29 29 29 29 29 29 29 29 29 29 29 29 29 29 29 29 29 29 29 29 29 29 29 29 29 125 
125 125 125 125 125 125 125 125 125 125 125 125 125 125 125 125 125 125 125 125 125 125 125 29 29 29 29 29 125 125 125 125 
