0 158 5 4 6 6 3 4 6 6 6 6 6 28 6 7 8 8 8 8 8 8 8 8 8 8 18 19 931 21 23 24 25
41 363 353 354 355 356 357 381 382 357 358 353 354 358 354 354 359 360 215 215 215 215 215 215 215 369 43 331 931 373 375 376 377
704 705 706 707 707 707 732 733 734 735 730 731 731 731 731 731 711 712 713 714 716 718 719 719 720 721 722 931 724 725 727 728 729
743 743 743 743 743 743 860 861 862 863 864 866 810 811 811 811 287 812 812 812 844 845 846 847 848 850 931 931 852 853 855 856 857
806 806 806 806 806 806 860 861 862 863 830 830 203 830 830 830 830 830 830 830 876 877 878 879 880 931 882 883 884 885 887 888 889
324 324 324 324 324 324 924 925 926 927 897 865 287 899 899 203 831 831 203 831 831 0 910 911 880 913 914 915 916 917 919 920 921
801 801 801 801 801 955 956 957 958 959 974 930 831 831 831 831 831 831 831 287 232 940 942 943 944 945 946 951 951 951 951 952 953
960 986 964 971 987 945 988 989 990 991 993 994 931 966 966 966 966 966 966 966 232 972 973 975 976 977 979 983 983 983 983 984 985
992 992 992 992 992 974 974 974 974 720 994 950 950 203 965 965 965 287 232 232 232 972 8 9 9 47 915 951 951 951 951 951 951
750 750 750 750 757 713 714 713 714 721 932 932 932 932 932 932 936 936 232 923 913 914 974 974 304 305 311 951 951 951 951 951 951
932 932 932 932 932 932 932 932 932 932 932 932 932 932 932 203 936 936 232 972 961 974 974 974 304 305 275 951 951 951 951 951 951
932 932 932 932 932 932 932 932 932 932 932 932 582 932 932 936 936 936 232 972 974 974 974 974 304 305 275 951 951 951 951 951 951
932 932 932 932 932 477 478 479 449 932 932 932 932 932 932 936 936 936 232 972 974 974 974 974 304 305 275 276 951 951 951 951 951
932 932 932 932 932 575 510 511 932 932 932 932 932 932 570 936 936 936 232 972 974 974 974 974 304 305 275 276 951 951 951 951 951
932 932 932 932 932 932 509 543 513 514 932 932 932 932 932 932 936 936 232 972 974 974 974 974 242 275 275 311 948 948 948 948 948
932 932 932 932 932 932 932 542 545 546 547 932 932 932 932 572 573 936 232 972 974 974 974 974 242 275 275 948 948 948 948 948 948
932 932 932 932 932 932 932 932 577 578 579 932 932 932 932 232 232 232 232 914 974 974 945 946 276 948 948 948 948 948 948 948 948
932 932 932 654 932 932 932 932 932 932 932 932 932 570 932 232 239 914 974 974 974 974 400 948 948 948 948 948 948 948 948 948 948
932 932 932 932 932 932 932 932 932 932 932 932 932 932 932 232 333 334 335 528 528 528 528 979 948 948 948 948 948 948 948 951 951
932 932 932 932 932 902 932 932 932 932 932 932 932 932 232 301 302 303 303 528 528 528 528 366 979 948 948 948 948 311 57 979 951
932 932 932 932 932 932 932 932 932 932 932 932 967 232 301 271 334 335 719 528 528 528 528 366 366 979 55 56 57 62 63 978 978
905 905 905 905 905 905 905 905 905 905 905 905 905 232 333 719 528 528 528 528 528 528 366 366 366 366 366 366 366 366 366 366 366
905 905 905 905 905 905 621 905 905 905 905 905 905 232 333 528 528 528 528 528 528 528 528 366 366 366 366 366 366 366 366 366 366
905 905 905 905 905 905 905 905 905 905 905 905 905 232 333 528 528 528 528 528 178 179 528 528 366 366 366 366 366 366 366 366 366
905 905 905 642 643 905 905 905 905 905 905 905 905 232 333 528 528 528 528 528 210 211 245 528 366 366 366 366 366 366 366 366 366
905 905 905 905 905 905 905 647 905 905 905 905 905 232 333 528 528 528 528 528 210 211 211 245 366 366 366 366 366 366 945 946 179
905 905 905 905 905 905 905 905 905 905 905 905 905 232 333 528 528 528 528 528 242 211 211 211 245 366 366 366 178 179 274 947 947
905 905 905 654 905 905 905 905 905 905 621 905 737 232 333 528 528 528 528 945 946 947 948 244 244 245 247 178 244 244 244 244 244
905 905 905 905 905 905 905 905 737 905 905 905 905 232 333 528 528 528 528 977 978 979 948 947 947 947 947 244 244 244 244 244 244
905 905 905 905 905 905 905 905 905 905 905 905 905 232 333 528 528 528 528 945 946 947 947 947 947 947 947 244 244 244 244 244 244
905 905 609 762 905 737 905 905 905 905 905 603 604 232 333 528 528 528 528 977 978 979 947 947 947 947 951 244 244 244 244 244 244
905 609 609 609 905 905 905 772 773 905 905 797 798 232 333 45 559 528 528 528 7 977 978 979 951 951 244 244 244 244 244 244 244
612 609 609 609 609 905 905 905 905 905 905 905 905 232 590 591 592 528 528 528 528 528 528 977 978 979 244 244 244 244 244 244 244
