23 23 23 23 23 23 23 23 23 23 23 23 23 23 23 23 23 23 23 23 23 23 23 23 23 23 23 23 23 23 23 23 23                  
23 23 23 23 23 23 23 23 23 23 23 23 23 23 23 23 23 23 23 23 23 23 23 23 23 23 23 23 23 23 23 23 23                  
23 23 23 23 23 23 20 23 23 23 23 23 23 23 23 23 23 23 23 23 23 23 23 23 23 23 23 23 23 23 23 23 23                  
23 23 23 23 23 21 17 22 20 20 20 20 20 22 23 23 23 23 23 23 23 23 23 23 23 20 20 20 23 23 23 23 23                  
23 23 23 23 21 17 17 17 17 17 17 17 17 17 22 23 23 23 23 23 23 23 23 23 21 17 17 17 22 20 23 23 23                  
23 23 23 21 17 17 17 17 17 17 17 17 17 17 17 22 23 23 23 23 23 23 23 21 17 17 17 17 17 17 22 23 23                  
20 20 21 17 17 17 17 17 17 17 17 17 17 17 17 17 22 20 20 20 20 20 20 17 17 17 17 17 17 17 17 22 20                  
17 17 17 17 17 17 17 17 17 17 17 17 17 17 17 17 17 17 17 17 17 17 17 17 17 17 17 17 17 17 17 17 17                  
17 17 17 17 17 17 17 17 17 17 17 17 17 17 17 17 17 17 17 17 17 17 17 17 17 17 17 17 17 17 17 17 17                  
17 17 17 17 17 17 17 17 17 17 17 17 17 17 17 17 17 17 17 17 17 17 17 17 17 17 17 17 17 17 17 17 17                  
17 17 17 17 17 17 17 17 17 17 17 17 17 17 17 17 17 17 17 17 17 17 17 17 17 17 17 17 17 17 17 17 17                  
17 17 17 17 17 17 17 17 17 17 17 17 17 17 17 17 17 17 17 17 17 17 17 17 17 17 17 17 17 17 17 17 17                  
17 17 17 17 17 17 17 17 17 17 17 17 17 17 17 17 17 17 17 17 17 17 17 17 17 17 17 17 17 17 17 17 17                  
17 17 17 17 17 17 17 17 17 17 17 17 17 17 17 17 17 17 17 17 17 17 17 17 17 17 17 17 17 17 17 17 17                  
17 17 17 17 17 17 17 17 17 17 17 17 17 17 17 17 17 17 17 17 17 17 17 17 17 17 17 17 17 17 17 17 17                  
17 17 17 17 17 17 17 17 17 17 17 17 17 17 9 10 8 17 17 17 17 17 17 17 17 17 17 17 17 17 17 17 17                  
17 17 17 17 17 17 17 17 17 17 17 17 17 17 12 13 11 17 17 17 17 17 17 17 17 17 17 17 17 17 17 17 17                  
17 17 17 17 17 17 17 17 17 17 17 17 17 17 15 16 14 17 17 17 17 17 17 17 17 17 17 17 17 17 17 17 17                  
17 17 17 17 17 17 17 17 17 17 17 17 17 17 17 17 17 17 17 17 17 17 17 17 17 17 17 17 17 17 17 17 17 17                 
17 17 17 17 17 17 17 17 18 18 18 18 18 18 18 18 18 18 18 18 18 18 18 18 18 17 17 17 17 17 17 17 17                  
17 17 17 17 17 17 18 18 7 7 7 7 7 7 7 7 7 7 32 24 32 33 24 7 7 18 17 17 17 17 17 17 17                  
17 17 17 17 17 18 7 7 6 6 6 6 6 6 6 6 6 6 34 36 38 36 37 6 6 7 18 18 17 17 17 17 17                  
17 17 17 18 18 7 6 6 6 6 6 6 6 6 6 6 6 6 34 34 26 27 28 6 6 6 7 7 18 18 17 17 17 17                 
17 18 18 7 7 6 6 6 6 6 6 6  2 1 6 6 6 34 34 25 36 25 6 6 6 6 6 7 7 18 18 18                  
18 7 7 6 6 6 6 6 6 6 6 6 5 4 3 6 6 6 34 34 34 28 28 6 6 6 6 6 6 6 7 7 7                  
7 6 6 6 6 6 6 6 6 6 6 6 6 6 6 6 6 6 34 34 34 34 34 6 6 6 6 6 6 6 6 6 6                  
6 6 6 6 6 6 6 6 6 6 6 6 6 6 6 6 6 6 34 34 34 34 28 6 6 6 6 6 6 6 6 6 6                  
6 6 6 6 6 6 6 6 6 6 6 6 6 6 6 6 6 6 34 34 34 34 28 6 6 6 6 6 6 6 6 6 6                  
6 6 6 6 6 6 6 6 6 6 6 6 6 6 6 6 6 6 34 34 36 35 35 6 6 6 6 6 6 6 6 6 6                  
6 6 6 6 6 6 6 6 6 6 6 6 6 6 6 6 6 6 34 34 35 35 35 6 6 6 6 6 6 6 6 6 6                  
6 6 6 6 6 6 6 6 6 6 6 6 6 6 6 6 6 6 34 34 35 35 35 6 6 6 6 6 6 6 6 6 6                  
6 6 6 6 6 6 6 6 6 6 6 6 6 6 6 6 6 6 29 31 30 31 29 6 6 6 6 6 6 6 6 6 6                  
6 6 6 6 6 6 6 6 6 6 6 6 6 6 6 6 6 6 6 6 6 6 6 6 6 6 6 6 6 6 6 6 6                  
