932 0 0 0 26 0 0 0 0 0 0 0 0 0 0 0 0 0 0 0 0 0 0 0 0 0 0 0 0 0 0 0 0 0 0 0 0 0 0 0 0 0 0 0 0 0 0 0 0 0 
963 956 997 0 0 0 0 20 21 0 0 0 0 0 863 0 0 0 0 0 0 30 30 30 0 0 0 26 0 0 0 0 0 0 0 0 0 0 0 0 0 0 0 0 0 0 0 0 0 0 
70 963 963 998 26 0 0 0 0 0 0 0 26 0 0 55 56 0 868 0 0 0 30 716 717 0 0 0 0 0 26 0 0 0 0 0 0 0 0 0 0 0 0 0 0 0 0 0 0 0 
963 104 963 963 997 0 0 0 0 0 0 0 0 0 0 0 0 868 868 855 0 0 0 844 845 0 0 863 0 0 0 0 0 0 0 0 0 0 0 0 0 0 0 0 0 0 0 0 0 0 
70 963 70 963 963 954 931 932 0 26 0 20 21 0 863 0 0 850 0 0 0 0 0 0 0 0 0 0 0 0 0 0 0 0 0 0 0 0 0 0 0 0 0 0 0 0 0 0 0 0 
963 963 963 104 963 963 963 963 932 0 0 0 0 0 0 0 0 0 0 0 0 0 0 0 0 0 121 112 111 116 111 110 111 0 0 0 0 0 0 0 0 0 0 0 0 0 0 0 0 0 
963 963 963 963 104 963 963 963 963 928 929 929 929 929 929 929 929 111 110 113 113 113 117 109 115 121 103 103 103 103 103 103 103 0 0 0 0 0 0 0 0 0 0 0 0 0 0 0 0 0 
960 971 982 986 987 988 989 991 963 963 963 963 963 963 963 963 963 963 963 963 963 963 963 963 963 963 963 963 963 963 963 963 963 0 0 0 0 0 0 0 0 0 0 0 0 0 0 0 0 0 
992 992 218 251 218 251 61 143 143 143 143 143 143 143 143 143 143 143 143 143 143 143 143 143 143 143 143 143 143 143 143 143 102 0 0 0 0 0 0 0 0 0 0 0 0 0 0 0 0 0 
32 32 310 314 314 314 61 168 168 168 168 168 168 168 168 168 168 168 168 168 168 168 168 168 168 168 168 168 168 168 168 168 168 0 0 0 0 0 0 0 0 0 0 0 0 0 0 0 0 0 
54 58 58 91 91 60 61 65 65 65 65 65 65 65 66 66 66 66 66 66 66 66 66 65 65 65 65 65 65 65 65 66 67 0 0 0 0 0 0 0 0 0 0 0 0 0 0 0 0 0 
96 96 90 91 91 91 93 271 271 97 98 99 271 271 271 271 271 271 271 271 271 271 271 271 271 271 271 271 271 271 271 271 271 0 0 0 0 0 0 0 0 0 0 0 0 0 0 0 0 0 
224 235 246 250 250 250 330 272 159 129 130 131 132 233 233 233 233 233 233 233 233 233 233 233 233 233 233 233 233 233 233 233 233 0 0 0 0 0 0 0 0 0 0 0 0 0 0 0 0 0 
224 267 250 250 250 250 330 190 191 161 162 163 164 165 166 268 268 268 268 268 268 268 268 268 268 268 268 268 268 268 268 268 268 0 0 0 0 0 0 0 0 0 0 0 0 0 0 0 0 0 
224 267 250 250 250 250 221 191 191 193 194 195 196 197 198 275 275 275 275 275 275 275 275 275 275 275 275 275 275 275 275 275 275 0 0 0 0 0 0 0 0 0 0 0 0 0 0 0 0 0 
224 235 250 250 250 252 253 254 255 225 226 227 228 229 230 265 265 265 265 265 265 264 264 264 264 265 264 265 265 265 264 264 265 0 0 0 0 0 0 0 0 0 0 0 0 0 0 0 0 0 
288 267 250 250 250 284 285 286 287 257 258 259 260 261 262 256 256 256 256 256 256 256 256 256 256 256 256 256 256 256 256 256 256 0 0 0 0 0 0 0 0 0 0 0 0 0 0 0 0 0 
288 171 154 154 154 316 317 318 319 289 290 291 292 293 294 256 256 256 256 256 256 256 256 256 256 256 256 256 256 256 256 256 256 0 0 0 0 0 0 0 0 0 0 0 0 0 0 0 0 0 
224 203 250 250 250 348 349 350 351 321 322 323 324 325 326 329 329 329 330 333 333 333 333 333 333 333 333 333 333 333 333 333 333 0 0 0 0 0 0 0 0 0 0 0 0 0 0 0 0 0 
341 171 310 310 310 412 413 414 415 385 386 387 388 389 390 327 328 329 330 332 332 332 335 336 332 332 332 332 332 332 332 332 332 0 0 0 0 0 0 0 0 0 0 0 0 0 0 0 0 0 
332 331 329 329 346 444 445 446 447 417 418 419 420 421 422 423 424 425 426 428 429 430 431 432 433 433 433 433 433 433 433 433 433 0 0 0 0 0 0 0 0 0 0 0 0 0 0 0 0 0 
332 267 246 250 250 250 477 478 479 449 474 474 474 453 478 455 455 455 455 460 461 462 463 464 469 469 469 469 469 469 469 469 469 0 0 0 0 0 0 0 0 0 0 0 0 0 0 0 0 0 
469 459 456 456 456 456 456 456 456 456 456 456 456 456 456 456 456 456 456 456 456 456 456 394 337 337 337 814 815 469 469 469 469 0 0 0 0 0 0 0 0 0 0 0 0 0 0 0 0 0 
337 504 534 506 527 515 525 525 540 525 525 543 527 527 540 526 526 543 519 520 521 522 524 528 672 672 672 672 818 818 672 672 672 0 0 0 0 0 0 0 0 0 0 0 0 0 0 0 0 0 
625 504 547 548 565 547 548 549 575 548 549 575 551 552 572 573 573 572 551 570 553 554 574 554 574 589 781 782 783 589 589 589 589 0 0 0 0 0 0 0 0 0 0 0 0 0 0 0 0 0 
584 584 584 584 584 584 584 584 584 584 584 584 584 584 584 584 584 584 584 584 584 584 584 584 584 584 584 584 584 584 584 584 584 0 0 0 0 0 0 0 0 0 0 0 0 0 0 0 0 0 
584 584 584 584 584 584 584 601 601 584 584 584 584 584 584 584 584 584 584 584 584 584 584 584 584 584 584 584 584 584 584 584 584 0 0 0 0 0 0 0 0 0 0 0 0 0 0 0 0 0 
584 584 584 580 584 584 584 584 601 623 601 584 584 584 584 584 584 584 584 584 584 584 741 742 584 584 584 584 584 584 584 584 584 0 0 0 0 0 0 0 0 0 0 0 0 0 0 0 0 0 
584 584 584 584 584 584 584 584 584 601 584 584 584 584 584 584 584 584 584 584 584 584 584 584 584 584 584 584 584 584 584 584 584 0 0 0 0 0 0 0 0 0 0 0 0 0 0 0 0 0 
584 584 584 584 584 584 584 584 584 584 584 584 584 584 584 584 584 584 584 584 584 584 584 584 584 584 584 584 584 584 584 584 584 0 0 0 0 0 0 0 0 0 0 0 0 0 0 0 0 0 
584 584 584 584 584 584 584 584 584 584 584 584 584 584 584 584 584 584 584 584 584 584 584 584 584 584 584 584 584 584 584 584 584 0 0 0 0 0 0 0 0 0 0 0 0 0 0 0 0 0 
584 584 584 584 584 584 584 584 584 584 584 584 584 584 584 584 584 584 584 584 584 584 584 584 584 584 584 584 584 584 584 584 584 0 0 0 0 0 0 0 0 0 0 0 0 0 0 0 0 0 
0 0 0 0 0 0 0 0 0 0 0 0 0 0 0 0 0 0 0 0 0 0 0 0 0 0 0 0 0 0 0 0 0 0 0 0 0 0 0 0 0 0 0 0 0 0 0 0 0 0 
0 0 0 0 0 0 0 0 0 0 0 0 0 0 0 0 0 0 0 0 0 0 0 0 0 0 0 0 0 0 0 0 0 0 0 0 0 0 0 0 0 0 0 0 0 0 0 0 0 0 
0 0 0 0 0 0 0 0 0 0 0 0 0 0 0 0 0 0 0 0 0 0 0 0 0 0 0 0 0 0 0 0 0 0 0 0 0 0 0 0 0 0 0 0 0 0 0 0 0 0 
0 0 0 0 0 0 0 0 0 0 0 0 0 0 0 0 0 0 0 0 0 0 0 0 0 0 0 0 0 0 0 0 0 0 0 0 0 0 0 0 0 0 0 0 0 0 0 0 0 0 
0 0 0 0 0 0 0 0 0 0 0 0 0 0 0 0 0 0 0 0 0 0 0 0 0 0 0 0 0 0 0 0 0 0 0 0 0 0 0 0 0 0 0 0 0 0 0 0 0 0 
0 0 0 0 0 0 0 0 0 0 0 0 0 0 0 0 0 0 0 0 0 0 0 0 0 0 0 0 0 0 0 0 0 0 0 0 0 0 0 0 0 0 0 0 0 0 0 0 0 0 
0 0 0 0 0 0 0 0 0 0 0 0 0 0 0 0 0 0 0 0 0 0 0 0 0 0 0 0 0 0 0 0 0 0 0 0 0 0 0 0 0 0 0 0 0 0 0 0 0 0 
0 0 0 0 0 0 0 0 0 0 0 0 0 0 0 0 0 0 0 0 0 0 0 0 0 0 0 0 0 0 0 0 0 0 0 0 0 0 0 0 0 0 0 0 0 0 0 0 0 0 
0 0 0 0 0 0 0 0 0 0 0 0 0 0 0 0 0 0 0 0 0 0 0 0 0 0 0 0 0 0 0 0 0 0 0 0 0 0 0 0 0 0 0 0 0 0 0 0 0 0 
0 0 0 0 0 0 0 0 0 0 0 0 0 0 0 0 0 0 0 0 0 0 0 0 0 0 0 0 0 0 0 0 0 0 0 0 0 0 0 0 0 0 0 0 0 0 0 0 0 0 
0 0 0 0 0 0 0 0 0 0 0 0 0 0 0 0 0 0 0 0 0 0 0 0 0 0 0 0 0 0 0 0 0 0 0 0 0 0 0 0 0 0 0 0 0 0 0 0 0 0 
0 0 0 0 0 0 0 0 0 0 0 0 0 0 0 0 0 0 0 0 0 0 0 0 0 0 0 0 0 0 0 0 0 0 0 0 0 0 0 0 0 0 0 0 0 0 0 0 0 0 
0 0 0 0 0 0 0 0 0 0 0 0 0 0 0 0 0 0 0 0 0 0 0 0 0 0 0 0 0 0 0 0 0 0 0 0 0 0 0 0 0 0 0 0 0 0 0 0 0 0 
0 0 0 0 0 0 0 0 0 0 0 0 0 0 0 0 0 0 0 0 0 0 0 0 0 0 0 0 0 0 0 0 0 0 0 0 0 0 0 0 0 0 0 0 0 0 0 0 0 0 
0 0 0 0 0 0 0 0 0 0 0 0 0 0 0 0 0 0 0 0 0 0 0 0 0 0 0 0 0 0 0 0 0 0 0 0 0 0 0 0 0 0 0 0 0 0 0 0 0 0 
0 0 0 0 0 0 0 0 0 0 0 0 0 0 0 0 0 0 0 0 0 0 0 0 0 0 0 0 0 0 0 0 0 0 0 0 0 0 0 0 0 0 0 0 0 0 0 0 0 0 
0 0 0 0 0 0 0 0 0 0 0 0 0 0 0 0 0 0 0 0 0 0 0 0 0 0 0 0 0 0 0 0 0 0 0 0 0 0 0 0 0 0 0 0 0 0 0 0 0 0 
0 0 0 0 0 0 0 0 0 0 0 0 0 0 0 0 0 0 0 0 0 0 0 0 0 0 0 0 0 0 0 0 0 0 0 0 0 0 0 0 0 0 0 0 0 0 0 0 0 0 
