168 168 168 168 168 168 168 168 168 168 168 168 168 168 168 168 168 168 168 168 168 168 168 168 168 168 168 168 168 168 168 168                   
168 47 47 47 47 47 47 47 47 47 47 47 47 47 168 47 47 47 47 47 47 47 47 47 47 47 47 47 47 47 47 168                   
168 47 47 47 47 47 47 47 47 47 47 47 47 47 168 47 47 47 47 47 47 47 47 47 47 47 47 47 47 47 47 168                   
168 47 47 47 47 47 47 141 142 143 47 47 47 47 168 47 47 47 47 47 47 47 47 47 47 47 47 47 47 47 47 168                   
168 47 47 47 44 47 47 144 145 146 47 47 47 47 168 47 47 47 47 47 47 47 47 47 47 47 47 47 47 47 47 168                   
168 47 47 47 45 47 47 147 148 149 47 22 47 47 168 47 47 47 47 47 36 37 38 39 47 91 47 47 47 47 47 168                   
168 47 47 47 47 47 47 47 47 47 47 47 47 47 168 47 47 47 47 47 40 41 42 43 47 92 47 47 47 47 47 168                   
168 47 47 47 47 47 47 47 47 85 85 47 47 47 168 47 47 47 47 47 47 47 47 47 47 47 47 47 47 47 47 168                   
168 47 47 47 47 47 47 47 47 86 86 47 47 47 168 47 47 47 47 47 47 47 47 47 47 47 47 47 47 47 47 168                   
168 47 47 47 47 47 47 47 47 47 47 47 47 47 168 47 47 47 47 47 47 47 47 47 47 47 47 47 47 47 47 168
168 47 2 47 47 47 47 47 47 2 47 47 47 47 168 47 47 47 47 47 47 47 47 47 47 47 47 47 47 47 47 168
168 47 47 47 47 47 47 47 47 47 47 47 47 47 168 47 47 47 47 47 47 47 47 47 47 47 47 47 47 47 47 168
168 47 47 47 47 47 47 47 47 47 47 47 47 47 168 47 47 47 47 47 47 47 47 47 47 47 47 47 47 47 47 168
168 47 47 47 47 47 47 47 47 47 47 47 47 47 168 47 47 47 47 47 47 47 47 47 47 47 47 47 47 47 47 168
168 47 47 47 47 47 47 47 47 47 47 47 47 47 47 47 47 47 47 47 47 47 47 47 47 47 47 47 47 47 47 168
168 47 47 47 47 47 47 47 47 47 47 47 47 47 47 47 47 47 47 48 48 48 48 48 48 48 48 48 48 47 47 168                   
168 47 47 47 47 47 47 47 47 47 47 47 47 47 47 47 47 47 47 48 46 46 46 46 46 46 46 46 48 47 47 168                   
168 47 47 47 47 47 47 47 47 47 47 47 47 47 47 47 47 47 47 48 46 46 46 46 46 46 46 46 48 47 47 168                   
168 47 47 47 47 47 47 47 47 47 47 47 47 47 47 47 47 47 47 48 46 46 46 46 46 46 46 46 48 47 47 168                   
168 168 168 168 168 168 168 168 168 168 168 168 168 168 168 47 47 47 47 48 46 46 46 46 46 46 46 46 48 47 47 168                   
168 47 47 47 47 47 47 47 47 47 47 47 47 47 47 47 47 47 47 48 48 48 48 47 47 48 48 48 48 47 47 168                   
168 47 47 47 47 47 47 47 47 47 47 47 47 47 47 47 47 47 47 47 47 47 47 47 47 47 47 47 47 47 47 168                   
168 47 47 47 47 47 47 47 47 47 47 47 47 47 47 47 47 47 47 47 47 47 47 47 47 47 47 47 47 47 47 168                   
168 47 47 47 47 47 47 47 47 47 47 47 47 47 47 47 47 2 47 32 33 47 47 104 105 47 47 32 33 47 2 168                   
168 47 47 47 47 85 85 47 47 47 47 47 47 47 47 47 47 47 47 34 35 47 47 106 107 47 47 34 35 47 47 168                   
168 47 47 47 47 86 86 47 47 47 47 47 47 47 47 47 47 47 47 47 47 47 47 47 47 47 47 47 47 47 47 168                   
168 47 47 85 93 94 95 96 85 47 47 47 47 47 47 47 47 47 47 47 47 47 47 47 47 47 47 47 47 47 47 168                   
168 47 47 86 97 98 99 100 86 47 47 47 47 47 47 47 47 47 47 47 47 47 47 47 47 47 47 47 47 47 47 168                   
168 47 47 47 47 47 47 47 47 47 47 47 47 47 47 47 47 47 47 47 47 47 47 47 47 47 47 47 47 47 47 168                   
168 47 47 47 47 47 47 47 47 47 47 47 47 47 47 47 47 47 47 47 47 47 47 47 47 47 47 47 47 47 47 168                   
168 47 47 47 47 47 47 47 47 47 47 47 47 47 47 47 47 47 47 47 47 47 47 47 47 47 47 47 47 47 47 168                   
168 47 47 47 47 47 47 47 47 47 47 47 47 47 47 47 47 47 47 47 47 47 47 47 47 47 47 47 47 47 47 168
168 47 47 47 47 47 47 47 47 47 47 47 47 47 47 47 47 47 47 47 47 47 47 47 47 47 47 47 47 47 47 168                   
168 168 168 168 168 168 168 168 168 168 168 168 168 168 168 168 168 168 168 168 168 168 168 47 47 47 47 168 168 168 168 168
