168 168 168 168 168 168 168 168 168 168 168 168 168 168 168 168 168 168 168 168 168 168 168 168 168 168 168 168 168 168 168 168 0 0 0 0 0 0 0 0 0 0 0 0 0 0 0 0 0 0 
168 168 168 168 168 168 168 168 168 168 168 168 168 168 168 168 168 168 168 168 168 168 168 168 168 168 168 168 168 168 168 168 0 0 0 0 0 0 0 0 0 0 0 0 0 0 0 0 0 0 
168 4 4 4 4 4 4 4 4 4 4 4 4 4 4 4 4 4 4 4 4 4 4 4 4 4 4 4 4 4 4 168 0 0 0 0 0 0 0 0 0 0 0 0 0 0 0 0 0 0 
168 4 4 4 4 4 4 4 4 4 4 4 4 4 4 4 4 4 4 4 4 4 4 4 4 4 4 4 4 4 4 168 0 0 0 0 0 0 0 0 0 0 0 0 0 0 0 0 0 0 
168 4 4 4 4 4 4 4 4 4 4 4 4 4 4 4 4 4 4 4 4 4 141 142 142 142 142 142 143 4 4 168 0 0 0 0 0 0 0 0 0 0 0 0 0 0 0 0 0 0 
168 4 104 105 104 105 104 105 104 105 104 105 4 4 4 4 4 4 4 4 4 4 144 148 148 148 148 148 146 4 4 168 0 0 0 0 0 0 0 0 0 0 0 0 0 0 0 0 0 0 
168 4 106 107 106 107 106 107 106 107 106 107 4 4 4 4 4 4 4 4 4 4 147 147 147 147 147 147 149 4 4 168 0 0 0 0 0 0 0 0 0 0 0 0 0 0 0 0 0 0 
168 4 4 4 4 4 4 4 4 4 104 105 4 4 4 4 4 4 4 4 4 4 147 147 147 147 147 147 149 4 4 168 0 0 0 0 0 0 0 0 0 0 0 0 0 0 0 0 0 0 
168 4 4 4 4 4 4 4 4 4 106 107 4 4 4 4 4 4 4 4 4 4 147 147 147 147 147 147 149 4 4 168 0 0 0 0 0 0 0 0 0 0 0 0 0 0 0 0 0 0 
168 4 4 4 4 4 4 4 4 4 104 105 4 4 4 23 24 25 4 4 4 4 144 145 145 145 145 145 146 4 4 168 0 0 0 0 0 0 0 0 0 0 0 0 0 0 0 0 0 0 
168 4 4 4 4 4 4 4 4 4 106 107 4 4 4 26 27 28 4 4 4 4 4 4 4 4 4 4 4 4 4 168 0 0 0 0 0 0 0 0 0 0 0 0 0 0 0 0 0 0 
168 4 4 4 4 4 4 4 4 4 104 105 4 4 4 29 30 31 4 4 4 4 4 4 4 4 4 4 4 4 4 168 0 0 0 0 0 0 0 0 0 0 0 0 0 0 0 0 0 0 
168 4 4 4 4 4 4 4 4 4 106 107 4 4 4 4 4 4 4 4 4 4 141 142 142 142 142 142 143 4 4 168 0 0 0 0 0 0 0 0 0 0 0 0 0 0 0 0 0 0 
168 4 4 4 4 4 4 4 4 4 104 105 4 4 4 4 4 4 4 4 4 4 144 145 145 145 145 145 146 4 4 168 0 0 0 0 0 0 0 0 0 0 0 0 0 0 0 0 0 0 
168 4 4 4 4 4 4 4 4 4 106 107 4 4 4 4 4 4 4 4 4 4 144 145 145 145 145 145 146 4 4 168 0 0 0 0 0 0 0 0 0 0 0 0 0 0 0 0 0 0 
168 4 4 4 4 4 4 4 4 4 4 4 4 4 4 4 4 4 4 4 4 4 144 145 145 145 145 145 146 4 4 168 0 0 0 0 0 0 0 0 0 0 0 0 0 0 0 0 0 0 
168 4 4 4 4 4 4 4 4 4 4 4 4 4 4 4 4 4 4 4 4 4 144 145 145 145 145 145 146 4 4 168 0 0 0 0 0 0 0 0 0 0 0 0 0 0 0 0 0 0 
168 4 4 4 4 4 4 4 4 4 4 4 4 4 4 91 91 91 4 4 4 4 147 148 148 148 148 148 149 4 4 168 0 0 0 0 0 0 0 0 0 0 0 0 0 0 0 0 0 0 
168 4 4 4 4 4 4 4 4 4 4 4 4 4 4 92 92 92 4 4 4 4 4 4 4 4 4 4 4 4 4 168 0 0 0 0 0 0 0 0 0 0 0 0 0 0 0 0 0 0 
168 4 4 4 4 4 4 4 4 4 4 4 4 4 4 4 4 4 4 4 4 4 4 4 4 4 4 4 4 4 4 168 0 0 0 0 0 0 0 0 0 0 0 0 0 0 0 0 0 0 
168 4 4 4 4 4 4 4 4 4 4 4 4 4 4 4 4 4 4 4 4 4 4 4 4 4 4 4 4 4 4 168 0 0 0 0 0 0 0 0 0 0 0 0 0 0 0 0 0 0 
168 4 4 4 4 4 4 4 4 4 4 4 4 4 4 4 4 4 4 4 4 4 4 4 4 4 4 4 4 4 4 168 0 0 0 0 0 0 0 0 0 0 0 0 0 0 0 0 0 0 
168 4 4 4 13 14 15 4 4 23 24 25 4 4 4 4 4 4 4 4 4 4 4 4 4 4 4 4 4 4 4 168 0 0 0 0 0 0 0 0 0 0 0 0 0 0 0 0 0 0 
168 4 4 4 16 17 18 4 4 26 27 28 4 4 4 4 4 4 4 4 4 4 4 4 4 4 4 4 4 4 4 168 0 0 0 0 0 0 0 0 0 0 0 0 0 0 0 0 0 0 
168 4 4 4 19 20 21 4 4 29 30 31 4 4 4 4 4 4 4 4 4 4 4 4 4 4 4 4 4 4 4 168 0 0 0 0 0 0 0 0 0 0 0 0 0 0 0 0 0 0 
168 4 4 4 4 4 4 4 4 4 4 4 4 4 4 4 4 4 4 4 4 4 4 4 4 4 4 4 4 4 4 168 0 0 0 0 0 0 0 0 0 0 0 0 0 0 0 0 0 0 
168 4 4 4 4 4 4 4 4 4 4 4 4 4 4 4 4 4 4 4 4 4 4 4 4 4 4 4 4 4 4 168 0 0 0 0 0 0 0 0 0 0 0 0 0 0 0 0 0 0 
168 168 168 168 168 168 168 168 168 168 168 168 168 168 168 168 168 168 168 168 168 168 168 168 168 168 168 168 168 168 168 168 0 0 0 0 0 0 0 0 0 0 0 0 0 0 0 0 0 0 
0 0 0 0 0 0 0 0 0 0 0 0 0 0 0 0 0 0 0 0 0 0 0 0 0 0 0 0 0 0 0 0 0 0 0 0 0 0 0 0 0 0 0 0 0 0 0 0 0 0 
0 0 0 0 0 0 0 0 0 0 0 0 0 0 0 0 0 0 0 0 0 0 0 0 0 0 0 0 0 0 0 0 0 0 0 0 0 0 0 0 0 0 0 0 0 0 0 0 0 0 
0 0 0 0 0 0 0 0 0 0 0 0 0 0 0 0 0 0 0 0 0 0 0 0 0 0 0 0 0 0 0 0 0 0 0 0 0 0 0 0 0 0 0 0 0 0 0 0 0 0 
0 0 0 0 0 0 0 0 0 0 0 0 0 0 0 0 0 0 0 0 0 0 0 0 0 0 0 0 0 0 0 0 0 0 0 0 0 0 0 0 0 0 0 0 0 0 0 0 0 0 
0 0 0 0 0 0 0 0 0 0 0 0 0 0 0 0 0 0 0 0 0 0 0 0 0 0 0 0 0 0 0 0 0 0 0 0 0 0 0 0 0 0 0 0 0 0 0 0 0 0 
0 0 0 0 0 0 0 0 0 0 0 0 0 0 0 0 0 0 0 0 0 0 0 0 0 0 0 0 0 0 0 0 0 0 0 0 0 0 0 0 0 0 0 0 0 0 0 0 0 0 
0 0 0 0 0 0 0 0 0 0 0 0 0 0 0 0 0 0 0 0 0 0 0 0 0 0 0 0 0 0 0 0 0 0 0 0 0 0 0 0 0 0 0 0 0 0 0 0 0 0 
0 0 0 0 0 0 0 0 0 0 0 0 0 0 0 0 0 0 0 0 0 0 0 0 0 0 0 0 0 0 0 0 0 0 0 0 0 0 0 0 0 0 0 0 0 0 0 0 0 0 
0 0 0 0 0 0 0 0 0 0 0 0 0 0 0 0 0 0 0 0 0 0 0 0 0 0 0 0 0 0 0 0 0 0 0 0 0 0 0 0 0 0 0 0 0 0 0 0 0 0 
0 0 0 0 0 0 0 0 0 0 0 0 0 0 0 0 0 0 0 0 0 0 0 0 0 0 0 0 0 0 0 0 0 0 0 0 0 0 0 0 0 0 0 0 0 0 0 0 0 0 
0 0 0 0 0 0 0 0 0 0 0 0 0 0 0 0 0 0 0 0 0 0 0 0 0 0 0 0 0 0 0 0 0 0 0 0 0 0 0 0 0 0 0 0 0 0 0 0 0 0 
0 0 0 0 0 0 0 0 0 0 0 0 0 0 0 0 0 0 0 0 0 0 0 0 0 0 0 0 0 0 0 0 0 0 0 0 0 0 0 0 0 0 0 0 0 0 0 0 0 0 
0 0 0 0 0 0 0 0 0 0 0 0 0 0 0 0 0 0 0 0 0 0 0 0 0 0 0 0 0 0 0 0 0 0 0 0 0 0 0 0 0 0 0 0 0 0 0 0 0 0 
0 0 0 0 0 0 0 0 0 0 0 0 0 0 0 0 0 0 0 0 0 0 0 0 0 0 0 0 0 0 0 0 0 0 0 0 0 0 0 0 0 0 0 0 0 0 0 0 0 0 
0 0 0 0 0 0 0 0 0 0 0 0 0 0 0 0 0 0 0 0 0 0 0 0 0 0 0 0 0 0 0 0 0 0 0 0 0 0 0 0 0 0 0 0 0 0 0 0 0 0 
0 0 0 0 0 0 0 0 0 0 0 0 0 0 0 0 0 0 0 0 0 0 0 0 0 0 0 0 0 0 0 0 0 0 0 0 0 0 0 0 0 0 0 0 0 0 0 0 0 0 
0 0 0 0 0 0 0 0 0 0 0 0 0 0 0 0 0 0 0 0 0 0 0 0 0 0 0 0 0 0 0 0 0 0 0 0 0 0 0 0 0 0 0 0 0 0 0 0 0 0 
0 0 0 0 0 0 0 0 0 0 0 0 0 0 0 0 0 0 0 0 0 0 0 0 0 0 0 0 0 0 0 0 0 0 0 0 0 0 0 0 0 0 0 0 0 0 0 0 0 0 
0 0 0 0 0 0 0 0 0 0 0 0 0 0 0 0 0 0 0 0 0 0 0 0 0 0 0 0 0 0 0 0 0 0 0 0 0 0 0 0 0 0 0 0 0 0 0 0 0 0 
0 0 0 0 0 0 0 0 0 0 0 0 0 0 0 0 0 0 0 0 0 0 0 0 0 0 0 0 0 0 0 0 0 0 0 0 0 0 0 0 0 0 0 0 0 0 0 0 0 0 
0 0 0 0 0 0 0 0 0 0 0 0 0 0 0 0 0 0 0 0 0 0 0 0 0 0 0 0 0 0 0 0 0 0 0 0 0 0 0 0 0 0 0 0 0 0 0 0 0 0 
0 0 0 0 0 0 0 0 0 0 0 0 0 0 0 0 0 0 0 0 0 0 0 0 0 0 0 0 0 0 0 0 0 0 0 0 0 0 0 0 0 0 0 0 0 0 0 0 0 0 
